puckman	小精灵: 吃豆 (日版 set 1, Probably 盗版)	小精灵: 吃豆 (日版 set 1, Probably 盗版)	Namco
puckmana	小精灵: 吃豆 (日版 set 2)	小精灵: 吃豆 (日版 set 2)	Namco
puckmanf	小精灵: 吃豆 (日版 set 1 with speedup hack)	小精灵: 吃豆 (日版 set 1 with speedup hack)	Namco
puckmanh	小精灵: 吃豆 (Falcom?)	小精灵: 吃豆 (Falcom?)	hack
pacman	小精灵: 吃豆 (Midway)	小精灵: 吃豆 (Midway)	[Namco] (Midway license)
pacmanf	小精灵: 吃豆 (Midway, with speedup hack)	小精灵: 吃豆 (Midway, with speedup hack)	[Namco] (Midway license)
puckmod	小精灵: 吃豆 (日版 set 3)	小精灵: 吃豆 (日版 set 3)	Namco
pacmod	小精灵: 吃豆 (Midway, harder)	小精灵: 吃豆 (Midway, harder)	[Namco] (Midway license)
newpuckx	小精灵: 吃豆 / New Pack X	小精灵: 吃豆 / New Pack X	hack
pacheart	小精灵: 吃豆 (Hearts)	小精灵: 吃豆 (Hearts)	hack
hangly	小精灵: 吃豆 / Hangly-Man (set 1)	小精灵: 吃豆 / Hangly-Man (set 1)	hack
hangly2	小精灵: 吃豆 / Hangly-Man (set 2)	小精灵: 吃豆 / Hangly-Man (set 2)	hack
hangly3	小精灵: 吃豆 / Hangly-Man (set 3)	小精灵: 吃豆 / Hangly-Man (set 3)	hack
piranhah	小精灵: 吃豆 / 食人鱼 (hack)	小精灵: 吃豆 / 食人鱼 (hack)	hack
pacplus	小精灵: 吃豆 / 吃豆 加强版	小精灵: 吃豆 / 吃豆 加强版	[Namco] (Midway license)
joyman	小精灵: 吃豆 / Joyman	小精灵: 吃豆 / Joyman	hack
piranha	小精灵: 吃豆 / 食人鱼	小精灵: 吃豆 / 食人鱼	GL (US Billiards License)
piranhao	小精灵: 吃豆 / 食人鱼 (older)	小精灵: 吃豆 / 食人鱼 (older)	GL (US Billiards License)
mspacman	小精灵: Ms. 吃豆	小精灵: Ms. 吃豆	Midway
mspacmnf	小精灵: Ms. 吃豆 (with speedup hack)	小精灵: Ms. 吃豆 (with speedup hack)	Midway
mspacmat	小精灵: Ms. 吃豆 / Ms. Pac Attack	小精灵: Ms. 吃豆 / Ms. Pac Attack	hack
mspacmab	小精灵: Ms. 吃豆 (盗版)	小精灵: Ms. 吃豆 (盗版)	bootleg
mspacmbe	Ms. Pac-Man (盗版, (encrypted))	Ms. Pac-Man (盗版, (encrypted))	bootleg
pacgal	小精灵: 吃豆女孩	小精灵: 吃豆女孩	hack
mspacpls	小精灵: Ms. 吃豆 Plus	小精灵: Ms. 吃豆 Plus	hack
alibaba	阿里巴巴和 40 大盗	阿里巴巴和 40 大盗	Sega
pengo	企鹅推冰 (set 1 rev c)	企鹅推冰 (set 1 rev c)	Sega
pengo2	企鹅推冰 (set 2)	企鹅推冰 (set 2)	Sega
pengo2u	企鹅推冰 (set 2 未加密)	企鹅推冰 (set 2 未加密)	Sega
pengo3u	企鹅推冰 (set 3 未加密)	企鹅推冰 (set 3 未加密)	Sega
pengo4	企鹅推冰 (set 4)	企鹅推冰 (set 4)	Sega
pengob	企鹅推冰 (盗版)	企鹅推冰 (盗版)	bootleg
galaxian	小蜜蜂 (Namco)	小蜜蜂 (Namco)	Namco
galaxiaj	小蜜蜂 (Namco set 2)	小蜜蜂 (Namco set 2)	Namco
galmidw	小蜜蜂 (Midway)	小蜜蜂 (Midway)	[Namco] (Midway license)
galmidwo	小蜜蜂 (Midway, old rev)	小蜜蜂 (Midway, old rev)	[Namco] (Midway license)
superg	超级小蜜蜂	超级小蜜蜂	hack
galapx	小蜜蜂 Part X	小蜜蜂 Part X	hack
moonaln	Moon Alien	Moon Alien	[Nichibutsu] (Karateco license)
galap1	小蜜蜂 / 宇宙入侵者 Galactica	小蜜蜂 / 宇宙入侵者 Galactica	hack
galap4	小蜜蜂 Part 4	小蜜蜂 Part 4	hack
galturbo	小蜜蜂 Turbo	小蜜蜂 Turbo	hack
swarm	小蜜蜂 / 蜂涌	小蜜蜂 / 蜂涌	hack
zerotime	小蜜蜂 / Zero Time	小蜜蜂 / Zero Time	Petaco S.A.
uniwars	银河帝国的反击 / UniWar S	银河帝国的反击 / UniWar S	Irem
gteikoku	银河帝国的反击	银河帝国的反击	Irem
gteikokb	银河帝国的反击 (盗版 set 1)	银河帝国的反击 (盗版 set 1)	bootleg
gteikob2	银河帝国的反击 (盗版 set 2)	银河帝国的反击 (盗版 set 2)	bootleg
spacbatt	银河帝国的反击 / Space Battle	银河帝国的反击 / Space Battle	bootleg
batman2	不死鸟 / Batman Part 2	不死鸟 / Batman Part 2	bootleg
pacmanbl	小精灵: 吃豆 (Galaxian hardware)	小精灵: 吃豆 (Galaxian hardware)	bootleg
devilfsg	魔神鱼类 (Galaxian 硬件, 盗版?)	魔神鱼类 (Galaxian 硬件, 盗版?)	Vision / Artic
zigzag	挖金子 / Zig Zag (Galaxian hardware, set 1)	挖金子 / Zig Zag (Galaxian hardware, set 1)	LAX
zigzag2	挖金子 / Zig Zag (Galaxian hardware, set 2)	挖金子 / Zig Zag (Galaxian hardware, set 2)	LAX
moonal2	月球异形 Part 2	月球异形 Part 2	Nichibutsu
moonal2b	月球异形 Part 2 (旧版)	月球异形 Part 2 (旧版)	Nichibutsu
supergx	超级 GX	超级 GX	Nichibutsu
frogg	青蛙过河 / Frog (Galaxian 硬件)	青蛙过河 / Frog (Galaxian 硬件)	bootleg
dkongjrm	大金刚 Jr. (Moon Cresta hardware)	大金刚 Jr. (Moon Cresta hardware)	bootleg
rockclim	攀岩者	攀岩者	Taito
atlantis	Atlantis 战争 (set 1)	Atlantis 战争 (set 1)	Comsoft
atlants2	Atlantis 战争 (set 2)	Atlantis 战争 (set 2)	Comsoft
ckongs	大金刚 / Crazy Kong (Scramble hardware)	大金刚 / Crazy Kong (Scramble hardware)	bootleg
froggers	青蛙过河 / Frog	青蛙过河 / Frog	bootleg
frogf	青蛙过河 / Frogger (Falcon bootleg)	青蛙过河 / Frogger (Falcon bootleg)	Falcon
devilfsh	魔神鱼类	魔神鱼类	Artic
scobra	超级眼镜蛇	超级眼镜蛇	Konami
scobras	超级眼镜蛇 (Stern)	超级眼镜蛇 (Stern)	[Konami] (Stern license)
scobrase	超级眼镜蛇 (Sega)	超级眼镜蛇 (Sega)	[Konami] (Sega license)
scobrab	超级眼镜蛇 (盗版)	超级眼镜蛇 (盗版)	bootleg
armorcar	装甲车 (set 1)	装甲车 (set 1)	Stern
armorca2	装甲车 (set 2)	装甲车 (set 2)	Stern
moonwar	月球战争 (set 1)	月球战争 (set 1)	Stern
moonwara	月球战争 (set 2)	月球战争 (set 2)	Stern
darkplnt	黑暗星球	黑暗星球	Stern
frogger	青蛙过河 / Frogger	青蛙过河 / Frogger	Konami
frogseg1	青蛙过河 / Frogger (Sega set 1)	青蛙过河 / Frogger (Sega set 1)	[Konami] (Sega license)
frogseg2	青蛙过河 / Frogger (Sega set 2)	青蛙过河 / Frogger (Sega set 2)	[Konami] (Sega license)
froggrmc	青蛙过河 / Frogger (Moon Cresta 硬件)	青蛙过河 / Frogger (Moon Cresta 硬件)	bootleg?
cclimber	疯狂爬梯者 (美版)	疯狂爬梯者 (美版)	Nichibutsu
cclimbrj	疯狂爬梯者 (日版)	疯狂爬梯者 (日版)	Nichibutsu
ccboot	疯狂爬梯者 (盗版 set 1)	疯狂爬梯者 (盗版 set 1)	bootleg
ccboot2	疯狂爬梯者 (盗版 set 2)	疯狂爬梯者 (盗版 set 2)	bootleg
ckong	大金刚 / Crazy Kong (set 1)	大金刚 / Crazy Kong (set 1)	Falcon
ckonga	大金刚 / Crazy Kong (set 2)	大金刚 / Crazy Kong (set 2)	Falcon
ckongjeu	大金刚 / Crazy Kong (Jeutel 盗版)	大金刚 / Crazy Kong (Jeutel 盗版)	bootleg
ckongo	大金刚 / Crazy Kong (Orca 盗版)	大金刚 / Crazy Kong (Orca 盗版)	bootleg
ckongalc	大金刚 / Crazy Kong (Alca 盗版)	大金刚 / Crazy Kong (Alca 盗版)	bootleg
bigkong	大金刚	大金刚	bootleg
monkeyd	大金刚 / Monkey Donkey	大金刚 / Monkey Donkey	bootleg
yamato	大和号 (美版)	大和号 (美版)	Sega
yamato2	大和号 (世界版)	大和号 (世界版)	Sega
ckongb	大金刚  (Alternative levels)	大金刚  (Alternative levels)	bootleg
gomoku	五目连珠	五目连珠	Nichibutsu
magmax	金属合体	金属合体	Nichibutsu
terracre	火凤凰 / 神鹰一号 (YM3526 set 1)	火凤凰 / 神鹰一号 (YM3526 set 1)	Nichibutsu
terracrb	火凤凰 / 神鹰一号 (YM3526 set 2)	火凤凰 / 神鹰一号 (YM3526 set 2)	Nichibutsu
terracra	火凤凰 / 神鹰一号 (YM2203)	火凤凰 / 神鹰一号 (YM2203)	Nichibutsu
amazon	圣战士 Amatelass / 少女战士 Amazon (世界版)	圣战士 Amatelass / 少女战士 Amazon (世界版)	Nichibutsu
amatelas	圣战士 Amatelass (日版)	圣战士 Amatelass (日版)	Nichibutsu
dangar	Dangar - UFO 变形金刚 (12/1/1986)	Dangar - UFO 变形金刚 (12/1/1986)	Nichibutsu
dangar2	Dangar - UFO 变形金刚 (9/26/1986)	Dangar - UFO 变形金刚 (9/26/1986)	Nichibutsu
dangarb	Dangar - UFO 变形金刚 (盗版)	Dangar - UFO 变形金刚 (盗版)	bootleg
ninjemak	妖魔忍法帖 / Ninja Emaki (美版)	妖魔忍法帖 / Ninja Emaki (美版)	Nichibutsu
youma	妖魔忍法帖 (日版)	妖魔忍法帖 (日版)	Nichibutsu
legion	超时迷宫 Legion (ver 2.03)	超时迷宫 Legion (ver 2.03)	Nichibutsu
legiono	超时迷宫 Legion (ver 1.05)	超时迷宫 Legion (ver 1.05)	Nichibutsu
kodure	子连狼 (日版)	子连狼 (日版)	Nichibutsu
armedf	武装编队	武装编队	Nichibutsu
cclimbr2	疯狂爬梯者 2 (日版)	疯狂爬梯者 2 (日版)	Nichibutsu
cclmbr2a	疯狂爬梯者 2 (日版 Harder)	疯狂爬梯者 2 (日版 Harder)	Nichibutsu
hyhoo	早押对战问答 HYHOO (日版)	早押对战问答 HYHOO (日版)	Nichibutsu
hyhoo2	早押对战问答 HYHOO 2 (日版)	早押对战问答 HYHOO 2 (日版)	Nichibutsu
crystalg	水晶女孩 (日版 860512)	水晶女孩 (日版 860512)	Nichibutsu
crystal2	水晶女孩 2 (日版 860620)	水晶女孩 2 (日版 860620)	Nichibutsu
citylove	都市之恋 (日版 860908)	都市之恋 (日版 860908)	Nichibutsu
mcitylov	都市之恋 [BET] (日版 860904)	都市之恋 [BET] (日版 860904)	Nichibutsu
secolove	第二情人 (日版 861201)	第二情人 (日版 861201)	Nichibutsu
housemnq	对家麻濡感 (日版 870217)	对家麻濡感 (日版 870217)	Nichibutsu
housemn2	对家麻濡感 六本木实况编 (日版 870418)	对家麻濡感 六本木实况编 (日版 870418)	Nichibutsu
seiha	制霸 (日版 870725)	制霸 (日版 870725)	Nichibutsu
seiham	制霸 [BET] (日版 870723)	制霸 [BET] (日版 870723)	Nichibutsu
bijokkoy	美女子梦物语 (日版 870925)	美女子梦物语 (日版 870925)	Nichibutsu
iemoto	家元 (日版 871020)	家元 (日版 871020)	Nichibutsu
bijokkog	美女子学园 (日版 880116)	美女子学园 (日版 880116)	Nichibutsu
orangec	橙色俱乐部 - 秘课外授业 (日版 880213)	橙色俱乐部 - 秘课外授业 (日版 880213)	Daiichi Denshi
orangeci	橙色俱乐部 - Maru-hi Ippatsu Kaihou [BET] (日版 880221)	橙色俱乐部 - Maru-hi Ippatsu Kaihou [BET] (日版 880221)	Daiichi Denshi
vipclub	VIP 俱乐部 - 秘一发开放 [BET] (日版 880310)	VIP 俱乐部 - 秘一发开放 [BET] (日版 880310)	Daiichi Denshi
kaguya	麻雀 家具屋公主 [BET] (日版 880521)	麻雀 家具屋公主 [BET] (日版 880521)	MIKI SYOUJI
otonano	大人麻雀 (日版 880628)	大人麻雀 (日版 880628)	Apple
kanatuen	金津园女子 [BET] (日版 880905)	金津园女子 [BET] (日版 880905)	Panac
mjsikaku	麻雀刺客 (日版 880908)	麻雀刺客 (日版 880908)	Nichibutsu
mjsikakb	麻雀刺客 (日版 880722)	麻雀刺客 (日版 880722)	Nichibutsu
mjcamera	麻雀 相机小僧 (set 1) (日版 881109)	麻雀 相机小僧 (set 1) (日版 881109)	MIKI SYOUJI
mmcamera	麻雀 相机小僧 [BET] (日版 890509)	麻雀 相机小僧 [BET] (日版 890509)	MIKI SYOUJI
msjiken	麻雀 杀人事件 (日版 881017)	麻雀 杀人事件 (日版 881017)	Nichibutsu
hanamomo	麻雀刺客外传 花之百子组! (日版 881201)	麻雀刺客外传 花之百子组! (日版 881201)	Nichibutsu
telmahjn	电话麻雀 (日版 890111)	电话麻雀 (日版 890111)	Nichibutsu
taiwanmb	台湾麻将 [BET] (日版 881208)	台湾麻将 [BET] (日版 881208)	MIKI SYOUJI
gionbana	只园花 (日版 890120)	只园花 (日版 890120)	Nichibutsu
idhimitu	偶像的秘密 [BET] (日版 890304)	偶像的秘密 [BET] (日版 890304)	Digital Soft
mjfocus	麻雀 聚焦 (日版 890313)	麻雀 聚焦 (日版 890313)	Nichibutsu
mjfocusm	麻雀 聚焦 [BET] (日版 890510)	麻雀 聚焦 [BET] (日版 890510)	Nichibutsu
peepshow	麻雀西洋景 (日版 890404)	麻雀西洋景 (日版 890404)	AC
scandal	Scandal 麻雀 (日版 890213)	Scandal 麻雀 (日版 890213)	Nichibutsu
scandalm	Scandal 麻雀 [BET] (日版 890217)	Scandal 麻雀 [BET] (日版 890217)	Nichibutsu
mgmen89	麻雀 G-MEN'89 (日版 890425)	麻雀 G-MEN'89 (日版 890425)	Nichibutsu
mjnanpas	麻雀 Nanpa Story (日版 890713)	麻雀 Nanpa Story (日版 890713)	BROOKS
mjnanpaa	麻雀 Nanpa Story (日版 890712)	麻雀 Nanpa Story (日版 890712)	BROOKS
mjnanpau	麻雀 Nanpa Story (里) (日版 890805)	麻雀 Nanpa Story (里) (日版 890805)	BROOKS
pairsten	电脑神经衰弱 Pairs (System Ten) (日版 890826)	电脑神经衰弱 Pairs (System Ten) (日版 890826)	System Ten
bananadr	麻雀 香蕉之梦 [BET] (日版 891124)	麻雀 香蕉之梦 [BET] (日版 891124)	Digital Soft
mladyhtr	麻雀 THE LADY HUNTER - 怪盗黑猫连盟编 (日版 900509)	麻雀 THE LADY HUNTER - 怪盗黑猫连盟编 (日版 900509)	Nichibutsu
chinmoku	麻雀 沉默编队 (日版 900511)	麻雀 沉默编队 (日版 900511)	Nichibutsu
maiko	舞妓花 (日版 900802)	舞妓花 (日版 900802)	Nichibutsu
club90s	90 年代麻雀俱乐部 (日版 set 1 900919)	90 年代麻雀俱乐部 (日版 set 1 900919)	Nichibutsu
club90sa	90 年代麻雀俱乐部 (日版 set 2 900919)	90 年代麻雀俱乐部 (日版 set 2 900919)	Nichibutsu
lovehous	爱家麻将 [BET] (日版 901024)	爱家麻将 [BET] (日版 901024)	Nichibutsu
hanaoji	花和欧吉桑 [BET] (日版 911209)	花和欧吉桑 [BET] (日版 911209)	Nichibutsu
pstadium	麻雀 惊恐竞技场 (日版)	麻雀 惊恐竞技场 (日版)	Nichibutsu
triplew1	麻雀 Triple Wars (日版)	麻雀 Triple Wars (日版)	Nichibutsu
triplew2	麻雀 Triple Wars 2 (日版)	麻雀 Triple Wars 2 (日版)	Nichibutsu
ntopstar	目标! Top Star 艺能界 Survival 麻雀 (日版)	目标! Top Star 艺能界 Survival 麻雀 (日版)	Nichibutsu
mjlstory	麻雀 实验爱情故事 (日版)	麻雀 实验爱情故事 (日版)	Nichibutsu
vanilla	麻雀 香草综合症 (日版)	麻雀 香草综合症 (日版)	Nichibutsu
finalbny	麻雀 最后的兔女郎 [BET] (日版)	麻雀 最后的兔女郎 [BET] (日版)	Nichibutsu
qmhayaku	问答 麻雀 早安! (日版)	问答 麻雀 早安! (日版)	Nichibutsu
galkoku	麻雀 女孩的告白 (日版)	麻雀 女孩的告白 (日版)	Nichibutsu/T.R.TEC
hyouban	麻雀 评判娘 [BET] (日版)	麻雀 评判娘 [BET] (日版)	Nichibutsu/T.R.TEC
galkaika	麻雀 如花少女 (日版)	麻雀 如花少女 (日版)	Nichibutsu/T.R.TEC
tokyogal	东京女子图鉴 (日版)	东京女子图鉴 (日版)	Nichibutsu
tokimbsj	胸骚美少女 [BET] (日版)	胸骚美少女 [BET] (日版)	Nichibutsu
mcontest	Miss 麻雀 Contest (日版)	Miss 麻雀 Contest (日版)	Nichibutsu
uchuuai	麻雀 来自宇宙的爱 (日版)	麻雀 来自宇宙的爱 (日版)	Nichibutsu
av2mj1bb	AV2 麻雀 Bay Bridge 圣女 (日版)	AV2 麻雀 Bay Bridge 圣女 (日版)	MIKI SYOUJI/AV JAPAN
av2mj2rg	AV2 麻雀 红粉佳人 (日版)	AV2 麻雀 红粉佳人 (日版)	MIKI SYOUJI/AV JAPAN
mjuraden	麻雀 占卜传说 (日版)	麻雀 占卜传说 (日版)	Nichibutsu/Yubis
koinomp	麻雀 恋爱的魔力 (日版)	麻雀 恋爱的魔力 (日版)	Nichibutsu
patimono	麻雀 柏青哥物语 (日版)	麻雀 柏青哥物语 (日版)	Nichibutsu
mjanbari	奖章麻雀 Janjan Baribari [BET] (日版)	奖章麻雀 Janjan Baribari [BET] (日版)	Nichibutsu/Yubis/AV JAPAN
ultramhm	极秘麻雀 (日版)	极秘麻雀 (日版)	Apple
gal10ren	麻将十连庄 (日版)	麻将十连庄 (日版)	FUJIC
renaiclb	麻雀恋爱俱乐部 (日版)	麻雀恋爱俱乐部 (日版)	FUJIC
mjlaman	麻雀情缘 (日版)	麻雀情缘 (日版)	Nichibutsu/AV JAPAN
mkeibaou	麻雀 竞马王 (日版)	麻雀 竞马王 (日版)	Nichibutsu
pachiten	奖章麻雀 Pachi-Slot 天国 [BET] (日版)	奖章麻雀 Pachi-Slot 天国 [BET] (日版)	Nichibutsu/MIKI SYOUJI/AV JAPAN
sailorws	麻雀 Triple Wars 番外编 水手之战 (日版)	麻雀 Triple Wars 番外编 水手之战 (日版)	Nichibutsu
sailorwa	麻雀 Triple Wars 番外编 水手之战 (日版) (set 2)	麻雀 Triple Wars 番外编 水手之战 (日版) (set 2)	Nichibutsu
sailorwr	麻雀 Triple Wars 番外编 水手之战-R 风云再起!! [BET] (日版)	麻雀 Triple Wars 番外编 水手之战-R 风云再起!! [BET] (日版)	Nichibutsu
psailor1	美少女雀士 漂亮水手 18 禁 (日版)	美少女雀士 漂亮水手 18 禁 (日版)	SPHINX
psailor2	美少女雀士 漂亮水手 2 (日版)	美少女雀士 漂亮水手 2 (日版)	SPHINX
otatidai	Disco 麻雀奖台  (日版)	Disco 麻雀奖台  (日版)	SPHINX
ngpgal	热血女孩 (日版)	热血女孩 (日版)	Nichibutsu
mjgottsu	麻雀 身临其境! (日版)	麻雀 身临其境! (日版)	Nichibutsu
bakuhatu	麻雀 爆发纯情传 (日版)	麻雀 爆发纯情传 (日版)	Nichibutsu
cmehyou	麻雀 巡回女豹 (日版)	麻雀 巡回女豹 (日版)	Nichibutsu/Kawakusu
mmehyou	奖章麻雀 巡回女豹 [BET] (日版)	奖章麻雀 巡回女豹 [BET] (日版)	Nichibutsu/Kawakusu
mjkoiura	麻雀 恋爱占卜 (日版)	麻雀 恋爱占卜 (日版)	Nichibutsu
mkoiuraa	麻雀 恋爱占卜 (set 2) (日版)	麻雀 恋爱占卜 (set 2) (日版)	Nichibutsu
imekura	疯狂麻雀 (日版)	疯狂麻雀 (日版)	SPHINX/AV JAPAN
mscoutm	麻雀 侦察员 - 潜入!! AV 撮影现场 (日版)	麻雀 侦察员 - 潜入!! AV 撮影现场 (日版)	SPHINX/AV JAPAN
mjegolf	麻雀 美眉高尔夫 (日版)	麻雀 美眉高尔夫 (日版)	FUJIC/AV JAPAN
niyanpai	娘牌 (日版)	娘牌 (日版)	Nichibutsu
phoenix	不死鸟 (Amstar)	不死鸟 (Amstar)	Amstar
phoenixa	不死鸟 (Centuri)	不死鸟 (Centuri)	Amstar (Centuri license)
phoenixb	不死鸟 (Centuri), Set 2	不死鸟 (Centuri), Set 2	Amstar (Centuri license)
phoenixt	不死鸟 (Taito)	不死鸟 (Taito)	Taito
phoenix3	不死鸟 (T.P.N.)	不死鸟 (T.P.N.)	bootleg
phoenixc	不死鸟 (IRECSA G.G.I Corp)	不死鸟 (IRECSA G.G.I Corp)	bootleg?
condor	不死鸟 / Condor	不死鸟 / Condor	Sidam
kaitei	海底探宝	海底探宝	Namco
tankbatt	坦克大战	坦克大战	Namco
rallyx	拉力赛 X	拉力赛 X	Namco
rallyxm	拉力赛 X (Midway)	拉力赛 X (Midway)	[Namco] (Midway license)
commsega	战场之狼 (Sega)	战场之狼 (Sega)	Sega
galaga	大蜜蜂 (Namco)	大蜜蜂 (Namco)	Namco
galagao	大蜜蜂 (Namco)	大蜜蜂 (Namco)	Namco
galagamw	大蜜蜂 (Midway)	大蜜蜂 (Midway)	[Namco] (Midway license)
galagamk	大蜜蜂 (Midway set 2)	大蜜蜂 (Midway set 2)	[Namco] (Midway license)
galagamf	大蜜蜂 (Midway set 1 with fast shoot hack)	大蜜蜂 (Midway set 1 with fast shoot hack)	[Namco] (Midway license)
gallag	大蜜蜂 / Gallag	大蜜蜂 / Gallag	bootleg
digdug	挖金子 (set 1)	挖金子 (set 1)	Namco
digdugb	挖金子 (set 2)	挖金子 (set 2)	Namco
digdugat	挖金子 (Atari)	挖金子 (Atari)	[Namco] (Atari license)
digduga1	挖金子 (Atari, rev 1)	挖金子 (Atari, rev 1)	[Namco] (Atari license)
dzigzag	挖金子 / Zig Zag (Dig Dug hardware)	挖金子 / Zig Zag (Dig Dug hardware)	bootleg
xevious	铁板阵 (Namco)	铁板阵 (Namco)	Namco
xeviousa	铁板阵 (Atari set 1)	铁板阵 (Atari set 1)	Namco (Atari license)
xeviousb	铁板阵 (Atari set 2)	铁板阵 (Atari set 2)	Namco (Atari license)
xeviousc	铁板阵 (Atari set 3)	铁板阵 (Atari set 3)	Namco (Atari license)
xevios	铁板阵 / Xevios	铁板阵 / Xevios	bootleg
sxevious	超级铁板阵	超级铁板阵	Namco
superpac	小精灵: 超级吃豆	小精灵: 超级吃豆	Namco
superpcm	小精灵: 超级吃豆 (Midway)	小精灵: 超级吃豆 (Midway)	[Namco] (Bally Midway license)
pacnpal	小精灵: 豆西 & 豆乐	小精灵: 豆西 & 豆乐	Namco
pacnpal2	小精灵: 豆西 & 豆乐 2 (旧版)	小精灵: 豆西 & 豆乐 2 (旧版)	Namco
mappy	猫捉鼠 (美版)	猫捉鼠 (美版)	Namco
mappyj	猫捉鼠 (日版)	猫捉鼠 (日版)	Namco
digdug2	挖金子 II (New Ver.)	挖金子 II (New Ver.)	Namco
digdug2o	挖金子 II (Old Ver.)	挖金子 II (Old Ver.)	Namco
todruaga	魂d之塔 (新版.)	魂d之塔 (新版.)	Namco
todruago	魂d之塔 (旧版.)	魂d之塔 (旧版.)	Namco
grobda	坦克大战 (新版.)	坦克大战 (新版.)	Namco
grobda2	坦克大战 (旧版. set 1)	坦克大战 (旧版. set 1)	Namco
grobda3	坦克大战 (旧版. set 2)	坦克大战 (旧版. set 2)	Namco
gaplus	大蜜蜂加强版 (rev. D)	大蜜蜂加强版 (rev. D)	Namco
gaplusa	大蜜蜂加强版 (alternate hardware)	大蜜蜂加强版 (alternate hardware)	Namco
gapluso	大蜜蜂加强版 (rev. B)	大蜜蜂加强版 (rev. B)	Namco
galaga3	大蜜蜂 3 (rev. C)	大蜜蜂 3 (rev. C)	Namco
galaga3m	大蜜蜂 3 (Midway)	大蜜蜂 3 (Midway)	Namco
galaga3a	大蜜蜂 3 (alternate set)	大蜜蜂 3 (alternate set)	Namco
topracer	顶尖赛手 (set 1)	顶尖赛手 (set 1)	bootleg
skykid	天空小子 (New Ver.)	天空小子 (New Ver.)	Namco
skykido	天空小子 (Old Ver.)	天空小子 (Old Ver.)	Namco
skykidd	天空小子 (60A1 Ver.)	天空小子 (60A1 Ver.)	Namco
metrocrs	障碍赛跑 (set 1)	障碍赛跑 (set 1)	Namco
metrocra	障碍赛跑 (set 2)	障碍赛跑 (set 2)	Namco
skykiddx	天空小子 (set 1)	天空小子 (set 1)	Namco
skykiddo	天空小子 (set 2)	天空小子 (set 2)	Namco
roishtar	Ishtar 复活	Ishtar 复活	Namco
genpeitd	源平讨魔传	源平讨魔传	Namco
rthunder	滚雷 (new version)	滚雷 (new version)	Namco
rthundro	滚雷 (old version)	滚雷 (old version)	Namco
wndrmomo	神奇女孩	神奇女孩	Namco
shadowld	妖怪道中记 / Shadow Land	妖怪道中记 / Shadow Land	Namco
youkaidk	妖怪道中记 (日版 new version)	妖怪道中记 (日版 new version)	Namco
yokaidko	妖怪道中记 (日版 old version)	妖怪道中记 (日版 old version)	Namco
dspirit	龙魂 (新版)	龙魂 (新版)	Namco
dspirito	龙魂 (旧版)	龙魂 (旧版)	Namco
pacmania	小精灵: 疯狂吃豆	小精灵: 疯狂吃豆	Namco
pacmanij	小精灵: 疯狂吃豆 (日版)	小精灵: 疯狂吃豆 (日版)	Namco
galaga88	大蜜蜂 '88 (set 1)	大蜜蜂 '88 (set 1)	Namco
galag88j	大蜜蜂 '88 (日版)	大蜜蜂 '88 (日版)	Namco
ws	世界竞技场 (日版)	世界竞技场 (日版)	Namco
berabohm	超绝伦人 Beraboh Man (日版 version C)	超绝伦人 Beraboh Man (日版 version C)	Namco
beraboho	超绝伦人 Beraboh Man (日版 version B)	超绝伦人 Beraboh Man (日版 version B)	Namco
bakutotu	爆突机铳艇	爆突机铳艇	Namco
wldcourt	世界球场	世界球场	Namco
splatter	鬼屋 (世界版)	鬼屋 (世界版)	Namco
ws89	世界竞技场 '89 (日版)	世界竞技场 '89 (日版)	Namco
dangseed	危机四伏 (日版)	危机四伏 (日版)	Namco
ws90	世界竞技场 '90 (日版)	世界竞技场 '90 (日版)	Namco
pistoldm	手枪大名冒险 (日版)	手枪大名冒险 (日版)	Namco
boxyboy	仓库番 豪华版 / Boxy Boy (美版)	仓库番 豪华版 / Boxy Boy (美版)	Namco
soukobdx	仓库番 豪华版 (日版)	仓库番 豪华版 (日版)	Namco
puzlclub	Puzzle俱乐部 (日版 工程版)	Puzzle俱乐部 (日版 工程版)	Namco
tankfrce	坦克大战 2 (美版)	坦克大战 2 (美版)	Namco
tankfrcj	坦克大战 2 (日版)	坦克大战 2 (日版)	Namco
ordyne	欧坦救美 (日版)	欧坦救美 (日版)	Namco
mirninja	未来忍者 (日版)	未来忍者 (日版)	Namco
phelios	翼人战士 (日版)	翼人战士 (日版)	Namco
dirtfoxj	污垢之狐 (日版)	污垢之狐 (日版)	Namco
burnforc	燃烧之魂 (日版)	燃烧之魂 (日版)	Namco
kyukaidk	球界道中记 (日版 新版)	球界道中记 (日版 新版)	Namco
kyukaido	球界道中记 (日版 旧版)	球界道中记 (日版 旧版)	Namco
rthun2	滚雷 2	滚雷 2	Namco
rthun2j	滚雷 2 (日版)	滚雷 2 (日版)	Namco
sws	超级世界棒球 (日版)	超级世界棒球 (日版)	Namco
sws92	超级世界棒球 '92 (日版)	超级世界棒球 '92 (日版)	Namco
sws92g	超级世界棒球 '92 - 激斗版 (日版)	超级世界棒球 '92 - 激斗版 (日版)	Namco
sws93	超级世界棒球 '93 (日版)	超级世界棒球 '93 (日版)	Namco
bkrtmaq	爆裂问答 魔 Q 大冒险 (日版)	爆裂问答 魔 Q 大冒险 (日版)	Namco
numanath	超能运动会 (世界版)	超能运动会 (世界版)	Namco
numanatj	超能运动会 (日版)	超能运动会 (日版)	Namco
quiztou	热斗! 激斗! 问题岛!! (日版)	热斗! 激斗! 问题岛!! (日版)	Namco
ptblank	枪林弹雨	枪林弹雨	Namco
gunbulet	枪林弹雨 (日版)	枪林弹雨 (日版)	Namco
gslgr94u	超级强打 '94	超级强打 '94	Namco
sws95	超级世界棒球 '95 (日版)	超级世界棒球 '95 (日版)	Namco
sws96	超级世界棒球 '96 (日版)	超级世界棒球 '96 (日版)	Namco
sws97	超级世界棒球 '97 (日版)	超级世界棒球 '97 (日版)	Namco
vshoot	J-联盟足球 V-Shoot	J-联盟足球 V-Shoot	Namco
outfxies	异域战狐	异域战狐	Namco
outfxesj	异域战狐 (日版)	异域战狐 (日版)	Namco
ncv1	Namco 名作剧场 Vol.1	Namco 名作剧场 Vol.1	Namco
ncv1j	Namco 名作剧场 Vol.1 (日版 set 1)	Namco 名作剧场 Vol.1 (日版 set 1)	Namco
ncv1j2	Namco 名作剧场 Vol.1 (日版 set 2)	Namco 名作剧场 Vol.1 (日版 set 2)	Namco
ncv2	Namco 名作剧场 Vol.2	Namco 名作剧场 Vol.2	Namco
ncv2j	Namco 名作剧场 Vol.2 (日版)	Namco 名作剧场 Vol.2 (日版)	Namco
zerohour	零时度	零时度	Universal
redclash	赤色冲击 (set 1)	赤色冲击 (set 1)	Tehkan
redclsha	赤色冲击 (set 2)	赤色冲击 (set 2)	Tehkan
redclask	赤色冲击 (Kaneko)	赤色冲击 (Kaneko)	Kaneko
devzone	魔鬼地带	魔鬼地带	Universal
devzone2	魔鬼地带 (easier)	魔鬼地带 (easier)	Universal
nomnlnd	战国自卫队 / No Man's Land	战国自卫队 / No Man's Land	Universal
nomnlndg	战国自卫队 / No Man's Land (Gottlieb)	战国自卫队 / No Man's Land (Gottlieb)	Universal (Gottlieb license)
docastle	Mr.Do! 对 独角兽 / Mr. Do 的城堡 (set 1)	Mr.Do! 对 独角兽 / Mr. Do 的城堡 (set 1)	Universal
docastl2	Mr.Do! 对 独角兽 / Mr. Do 的城堡 (set 2)	Mr.Do! 对 独角兽 / Mr. Do 的城堡 (set 2)	Universal
douni	Mr.Do! 对 独角兽	Mr.Do! 对 独角兽	Universal
dowild	Mr.Do 暴走	Mr.Do 暴走	Universal
helifire	地狱火 (revision B)	地狱火 (revision B)	Nintendo
helifira	地狱火 (revision A)	地狱火 (revision A)	Nintendo
dkong	大金刚 (美版 set 1)	大金刚 (美版 set 1)	Nintendo of America
dkongo	大金刚 (美版 set 2)	大金刚 (美版 set 2)	Nintendo
dkongjp	大金刚 (日版 set 1)	大金刚 (日版 set 1)	Nintendo
dkongjo	大金刚 (日版 set 2)	大金刚 (日版 set 2)	Nintendo
dkongjo1	大金刚 (日版 set 3) (bad dump?)	大金刚 (日版 set 3) (bad dump?)	Nintendo
dkongjr	大金刚 Junior (美版)	大金刚 Junior (美版)	Nintendo of America
dkongjrj	大金刚 Jr. (日版)	大金刚 Jr. (日版)	Nintendo
dkngjnrj	大金刚 Junior (日版?)	大金刚 Junior (日版?)	Nintendo
dkongjrb	大金刚 Jr. (盗版)	大金刚 Jr. (盗版)	bootleg
dkngjnrb	大金刚 Junior (盗版?)	大金刚 Junior (盗版?)	Nintendo of America
dkong3	大金刚 3 (美版)	大金刚 3 (美版)	Nintendo of America
dkong3j	大金刚 3 (日版)	大金刚 3 (日版)	Nintendo
dkong3b	大金刚 3 (盗版 on Donkey Kong Jr. hardware)	大金刚 3 (盗版 on Donkey Kong Jr. hardware)	bootleg
mario	马里奥兄弟 (美版)	马里奥兄弟 (美版)	Nintendo of America
mariojp	马里奥兄弟 (日版)	马里奥兄弟 (日版)	Nintendo
masao	马里奥兄弟 / Masao	马里奥兄弟 / Masao	bootleg
popeye	大力水手 (revision D)	大力水手 (revision D)	Nintendo
popeyeu	大力水手 (revision D not protected)	大力水手 (revision D not protected)	Nintendo
popeyef	大力水手 (revision F)	大力水手 (revision F)	Nintendo
popeyebl	大力水手 (盗版)	大力水手 (盗版)	bootleg
pc_tenis	网球 (PlayChoice-10)	网球 (PlayChoice-10)	Nintendo
pc_mario	马里奥兄弟 (PlayChoice-10)	马里奥兄弟 (PlayChoice-10)	Nintendo
pc_kngfu	功夫 (PlayChoice-10)	功夫 (PlayChoice-10)	Irem (Nintendo license)
pc_smb	超级 马里奥兄弟 (PlayChoice-10)	超级 马里奥兄弟 (PlayChoice-10)	Nintendo
pc_vball	排球 (PlayChoice-10)	排球 (PlayChoice-10)	Nintendo
pc_grdus	宇宙巡航机 (PlayChoice-10)	宇宙巡航机 (PlayChoice-10)	Konami
pc_grdue	宇宙巡航机 (PlayChoice-10 older)	宇宙巡航机 (PlayChoice-10 older)	Konami
pc_trjan	斗者挽歌 (PlayChoice-10)	斗者挽歌 (PlayChoice-10)	Capcom USA (Nintendo of America license)
pc_cvnia	恶魔城 (PlayChoice-10)	恶魔城 (PlayChoice-10)	Konami (Nintendo of America license)
pc_cntra	魂斗罗 (PlayChoice-10)	魂斗罗 (PlayChoice-10)	Konami (Nintendo of America license)
pc_ngaid	忍者龙剑传 (PlayChoice-10)	忍者龙剑传 (PlayChoice-10)	Tecmo (Nintendo of America license)
pc_tmnt	忍者神龟 / 激龟忍者传 (PlayChoice-10)	忍者神龟 / 激龟忍者传 (PlayChoice-10)	Konami (Nintendo of America license)
pc_drmro	马里奥医生 (PlayChoice-10)	马里奥医生 (PlayChoice-10)	Nintendo
pc_ddrgn	双截龙 (PlayChoice-10)	双截龙 (PlayChoice-10)	Technos
pc_smb2	超级马里奥兄弟 2 (PlayChoice-10)	超级马里奥兄弟 2 (PlayChoice-10))	Nintendo
pc_smb3	超级马里奥兄弟 3 (PlayChoice-10)	超级马里奥兄弟 3 (PlayChoice-10)	Nintendo
pc_mman3	洛克人 3 (PlayChoice-10)	洛克人 3 (PlayChoice-10)	Capcom USA (Nintendo of America license)
pc_suprc	超级魂斗罗 (PlayChoice-10)	超级魂斗罗 (PlayChoice-10)	Konami (Nintendo of America license)
pc_tmnt2	忍者神龟 / 激龟忍者传 2 (PlayChoice-10)	忍者神龟 / 激龟忍者传 2 (PlayChoice-10)	Konami (Nintendo of America license)
pc_wcup	热血高校躲避球部 Saka 编 (PlayChoice-10)	热血高校躲避球部 Saka 编 (PlayChoice-10)	Technos (Nintendo license)
pc_ngai2	忍者龙剑传 2 (PlayChoice-10)	忍者龙剑传 2 (PlayChoice-10)	Tecmo (Nintendo of America license)
pc_ngai3	忍者龙剑传 3 (PlayChoice-10)	忍者龙剑传 3 (PlayChoice-10)	Tecmo (Nintendo of America license)
pc_moglf	马里奥户外高尔夫 (PlayChoice-10)	马里奥户外高尔夫 (PlayChoice-10)	Nintendo
btlecity	对决: 坦克大战	对决: 坦克大战	Namco
cstlevna	对决: 恶魔城	对决: 恶魔城	Konami
drmario	对决: 马里奥医生	对决: 马里奥医生	Nintendo
iceclimb	对决: 敲冰块	对决: 敲冰块	Nintendo
iceclmbj	对决: 敲冰块 (日版)	对决: 敲冰块 (日版)	Nintendo
suprmrio	对决: 超级马里奥.	对决: 超级马里奥.	Nintendo
suprmria	对决: 超级马里奥. (alt)	对决: 超级马里奥. (alt)	Nintendo
vsskykid	对决: 空中小子	对决: 空中小子	Namco
vspinbal	对决: 弹珠台	对决: 弹珠台	Nintendo
vspinblj	对决: 弹珠台 (日版)	对决: 弹珠台 (日版)	Nintendo
vsslalom	对决: 回环滑雪	对决: 回环滑雪	Rare LTD.
vssoccer	对决: 足球	对决: 足球	Nintendo
vsgradus	对决: 宇宙巡航机	对决: 宇宙巡航机	Konami
vstetris	对决: 俄罗斯方块	对决: 俄罗斯方块	Academysoft-Elory
jajamaru	对战 忍者 Jaja 丸 (日版)	对战 忍者 Jaja 丸 (日版)	Jaleco
vstennis	对决: 网球	对决: 网球	Nintendo
vstennij	对决: 网球 (日版)	对决: 网球 (日版)	Nintendo
vsmahjng	对决: 麻雀 (日版)	对决: 麻雀 (日版)	Nintendo
vsbball	对决: 棒球	对决: 棒球	Nintendo of America
vsbballj	对决: 棒球 (日版 set 1)	对决: 棒球 (日版 set 1)	Nintendo of America
vsbbalja	对决: 棒球 (日版 set 2)	对决: 棒球 (日版 set 2)	Nintendo of America
iceclmrj	对战 敲冰块 Dual (日版)	对战 敲冰块 Dual (日版)	Nintendo
supxevs	对决: 超级 铁板阵	对决: 超级 铁板阵	Namco
vsbbaljb	对决: 棒球 (日版 set 3)	对决: 棒球 (日版 set 3)	Nintendo of America
nss_ssoc	Nintendo Super System: 超级足球	Nintendo Super System: 超级足球	Human Inc.
nss_actr	Act Raiser (Nintendo Super System)	Act Raiser (Nintendo Super System)	Enix
nss_con3	Nintendo Super System: 魂斗罗 3: 异形战争	Nintendo Super System: 魂斗罗 3: 异形战争	Konami
nss_rob3	Nintendo Super System: 机械战警 / 铁甲威龙 3	Nintendo Super System: 机械战警 / 铁甲威龙 3	Ocean
nss_smw	Nintendo Super System: 超级 马里奥世界	Nintendo Super System: 超级 马里奥世界	Nintendo
nss_sten	Nintendo Super System: 超级网球	Nintendo Super System: 超级网球	Nintendo
seawolf	海狼	海狼	Midway
maze	奇异迷宫	奇异迷宫	Midway
desertgu	沙漠枪手	沙漠枪手	Midway
phantom2	幻影 II	幻影 II	Midway
bowler	4 人保龄球	4 人保龄球	Midway
invaders	宇宙侵略者	宇宙侵略者	Midway
invad2ct	宇宙侵略者 II Cocktail (Midway)	宇宙侵略者 II Cocktail (Midway)	Midway
invadpt2	宇宙侵略者 Part II (Taito)	宇宙侵略者 Part II (Taito)	Taito
invaddlx	宇宙侵略者 豪华版	宇宙侵略者 豪华版	Midway
spaceatt	宇宙侵略者 / Space Attack	宇宙侵略者 / Space Attack	Video Games GMBH
spaceat2	宇宙侵略者 / Space Attack II	宇宙侵略者 / Space Attack II	Zenitone-Microsec Ltd
sinvzen	宇宙侵略者 (Zenitone-Microsec)	宇宙侵略者 (Zenitone-Microsec)	Zenitone-Microsec Ltd
superinv	宇宙侵略者	宇宙侵略者	bootleg
sstrangr	宇宙侵略者 / 太空妖怪	宇宙侵略者 / 太空妖怪	Yachiyo Electronics, Ltd.
sstrngr2	宇宙侵略者 / 太空妖怪 2	宇宙侵略者 / 太空妖怪 2	Yachiyo Electronics, Ltd.
sinvemag	宇宙侵略者 / 非常入侵者　(EMAG)	宇宙侵略者 / 非常入侵者　(EMAG)	bootleg
jspecter	宇宙侵略者 / Jatre Spector (set 1)	宇宙侵略者 / Jatre Spector (set 1)	Jatre
jspectr2	宇宙侵略者 / Jatre Specter (set 2)	宇宙侵略者 / Jatre Specter (set 2)	Jatre
galxwars	银河战争 (Universal set 1)	银河战争 (Universal set 1)	Universal
galxwar2	银河战争 (Universal set 2)	银河战争 (Universal set 2)	Universal
galxwart	银河战争 (Taito?)	银河战争 (Taito?)	Taito?
starw	银河战争 / 星球大战	银河战争 / 星球大战	bootleg
lrescue	月球营救	月球营救	Taito
lrescuem	月球营救 (Model Racing bootleg)	月球营救 (Model Racing bootleg)	Taito (Model Racing bootleg)
grescue	银河援救	银河援救	Taito (Universal license?)
desterth	目标地球	目标地球	bootleg
cosmicmo	宇宙侵略者 / 宇宙怪物	宇宙侵略者 / 宇宙怪物	Universal
cosmicm2	宇宙侵略者 2 / 宇宙怪物 2	宇宙侵略者 2 / 宇宙怪物 2	Universal
ozmawars	Ozma 战争 (set 1)	Ozma 战争 (set 1)	SNK
ozmawar2	Ozma 战争 (set 2)	Ozma 战争 (set 2)	SNK
solfight	Ozma 战争 / Solar Fight	Ozma 战争 / Solar Fight	bootleg
spaceph	Ozma 战争 / 宇宙幻影	Ozma 战争 / 宇宙幻影	Zilec Games
lupin3	鲁邦三世	鲁邦三世	Taito
spclaser	宇宙镭射 / Space Laser	宇宙镭射 / Space Laser	GamePlan (Taito)
spcewarl	宇宙镭射 / Space War (Leijac)	宇宙镭射 / Space War (Leijac)	Leijac (Konami)
m79amb	M79 伏击	M79 伏击	RamTek
alieninv	宇宙侵略者 / 异形入侵 Part II	宇宙侵略者 / 异形入侵 Part II	bootleg
sitv	宇宙侵略者 (TV Version)	宇宙侵略者 (TV Version)	Taito
sicv	宇宙侵略者 (CV Version)	宇宙侵略者 (CV Version)	Taito
sisv	宇宙侵略者 (SV Version)	宇宙侵略者 (SV Version)	Taito
sisv2	宇宙侵略者 (SV Version 2)	宇宙侵略者 (SV Version 2)	Taito
spacewr3	宇宙侵略者 3 / 太空战争 3	宇宙侵略者 3 / 太空战争 3	bootleg
invaderl	宇宙侵略者 (Logitec)	宇宙侵略者 (Logitec)	bootleg
invader4	宇宙侵略者 4	宇宙侵略者 4	bootleg
yosakdon	与作和东平 (盗版)	与作和东平 (盗版)	Wing
yosakdoa	与作和东平 (set 2)	与作和东平 (set 2)	Wing
spceking	宇宙侵略者 / Space King	宇宙侵略者 / Space King	Leijac (Konami)
spcewars	宇宙侵略者 / 太空战争 (Sanritsu)	宇宙侵略者 / 太空战争 (Sanritsu)	Sanritsu
wallst	华尔街	华尔街	Century Electronics
seawolf2	海狼 II	海狼 II	Midway
twotiger	双虎	双虎	Bally Midway
spyhunt	抓间谍	抓间谍	Bally Midway
spyhunt2	抓间谍 2 (rev 2)	抓间谍 2 (rev 2)	Bally Midway
spyhnt2a	抓间谍 2 (rev 1)	抓间谍 2 (rev 1)	Bally Midway
snakjack	顽皮杰克	顽皮杰克	Bally/Sente
toggle	Toggle (工程版)	Toggle (工程版)	Bally/Sente
redalert	第三次世界大战 / 红色警戒	第三次世界大战 / 红色警戒	Irem + GDI
mpatrol	月球巡警	月球巡警	Irem
mpatrolw	月球巡警 (Williams)	月球巡警 (Williams)	Irem (Williams license)
troangel	夏日天使	夏日天使	Irem
newtangl	新夏日天使	新夏日天使	Irem
kungfum	成龙踢馆 / Kung Fu Master	成龙踢馆 / Kung Fu Master	Irem
kungfud	成龙踢馆 / Kung Fu Master (Data East)	成龙踢馆 / Kung Fu Master (Data East)	Irem (Data East license)
spartanx	成龙踢馆 / Kung Fu Master (日版)	成龙踢馆 / Kung Fu Master (日版)	Irem
kungfub	成龙踢馆 / Kung Fu Master (盗版 set 1)	成龙踢馆 / Kung Fu Master (盗版 set 1)	bootleg
kungfub2	成龙踢馆 / Kung Fu Master (盗版 set 2)	成龙踢馆 / Kung Fu Master (盗版 set 2)	bootleg
ldrun	淘金者 (set 1)	淘金者 (set 1)	Irem (licensed from Broderbund)
ldruna	淘金者 (set 2)	淘金者 (set 2)	Irem (licensed from Broderbund)
ldrun2	淘金者 II - Bungeling 帝国的反击	淘金者 II - Bungeling 帝国的反击	Irem (licensed from Broderbund)
ldrun3	淘金者 III - 魔神复活	淘金者 III - 魔神复活	Irem (licensed from Broderbund)
ldrun3jp	淘金者 III - Majin No Fukkatsu	淘金者 III - Majin No Fukkatsu	Irem (licensed from Broderbund)
ldrun4	淘金者 IV - 逃离帝国	淘金者 IV - 逃离帝国	Irem (licensed from Broderbund)
kidniki	快杰 Yancha 丸 / Kid Niki (世界版)	快杰 Yancha 丸 / Kid Niki (世界版)	Irem
kidnikiu	快杰 Yancha 丸 / Kid Niki (美版)	快杰 Yancha 丸 / Kid Niki (美版)	Irem (Data East USA license)
yanchamr	快杰 Yancha 丸 (日版)	快杰 Yancha 丸 (日版)	Irem
spelunkr	洞穴探险	洞穴探险	Irem (licensed from Broderbund)
spelnkrj	洞穴探险 (日版)	洞穴探险 (日版)	Irem (licensed from Broderbund)
spelunk2	洞穴探险 II - 23 之钥	洞穴探险 II - 23 之钥	Irem (licensed from Broderbund)
youjyudn	妖兽传 (日版)	妖兽传 (日版)	Irem
vigilant	成龙踢馆 2 (世界版)	成龙踢馆 2 (世界版)	Irem
vigilntu	成龙踢馆 2 (美版)	成龙踢馆 2 (美版)	Irem (Data East USA license)
vigilntj	成龙踢馆 2 (日版)	成龙踢馆 2 (日版)	Irem
kikcubic	迷宫岛 (日版)	迷宫岛 (日版)	Irem
rtype	龙神号 / 异域战机 (日版)	龙神号 / 异域战机 (日版)	Irem
rtypeu	龙神号 / 异域战机 (美版)	龙神号 / 异域战机 (美版)	Irem (Nintendo of America license)
bchopper	Mr.HELI 大冒险 / Battle Chopper	Mr.HELI 大冒险 / Battle Chopper	Irem
mrheli	Mr.HELI 大冒险	Mr.HELI 大冒险	Irem
nspirit	最后的忍道	最后的忍道	Irem
nspiritj	最后的忍道 (日版)	最后的忍道 (日版)	Irem
xmultipl	X 战机 (日版)	X 战机 (日版)	Irem
rtype2	龙神号 II / 异域战机 II	龙神号 II / 异域战机 II	Irem
rtype2j	龙神号 II / 异域战机 II (日版)	龙神号 II / 异域战机 II (日版)	Irem
hharry	大力工头: 阿源 / Hammerin' Harry (世界版)	大力工头: 阿源 / Hammerin' Harry (世界版)	Irem
hharryu	大力工头: 阿源 / Hammerin' Harry (美版)	大力工头: 阿源 / Hammerin' Harry (美版)	Irem America
dkgensan	大力工头: 阿源 (日版)	大力工头: 阿源 (日版)	Irem
dkgenm72	大力工头: 阿源 (日版, M72)	大力工头: 阿源 (日版, M72)	Irem
airduel	空中决战 (日版)	空中决战 (日版)	Irem
gallop	雷驰 - 武装警察 (日版)	雷驰 - 武装警察 (日版)	Irem
kengo	剑豪	剑豪	Irem
sichuan2	四川省 女子寮编 / Sichuan II (hack?) (set 1)	四川省 女子寮编 / Sichuan II (hack?) (set 1)	Tamtex
sichuana	四川省 女子寮编 / Sichuan II (hack?) (set 2)	四川省 女子寮编 / Sichuan II (hack?) (set 2)	Tamtex
shisen	四川省 女子寮编 (日版)	四川省 女子寮编 (日版)	Tamtex
matchit	Match It	Match It	Tamtex
hasamu	霸沙梦 (日版)	霸沙梦 (日版)	Irem
bombrman	炸弹人 (日版)	炸弹人 (日版)	Irem (licensed from Hudson Soft)
bbmanw	炸弹人世界 (世界版)	炸弹人世界 (世界版)	Irem
bbmanwj	炸弹人世界 (日版)	炸弹人世界 (日版)	Irem
bomblord	炸弹人公爵 (盗版)	炸弹人公爵 (盗版)	bootleg
newapunk	新炸弹人 - 全球探索 (美版)	新炸弹人 - 全球探索 (美版)	Irem America
gunforce	Gunforce - 战火惊魂 (世界版)	Gunforce - 战火惊魂 (世界版)	Irem
gunforcu	Gunforce - 战火惊魂 (美版)	Gunforce - 战火惊魂 (美版)	Irem America
gunforcj	Gunforce - 战火惊魂 (日版)	Gunforce - 战火惊魂 (日版)	Irem
bmaster	刀锋领主 (世界版)	刀锋领主 (世界版)	Irem
lethalth	致命因子 (世界版)	致命因子 (世界版)	Irem
thndblst	致命因子 (日版)	致命因子 (日版)	Irem
uccops	玉面威龙 / 暴力刑警 (世界版)	玉面威龙 / 暴力刑警 (世界版)	Irem
uccopsj	玉面威龙 / 暴力刑警 (日版)	玉面威龙 / 暴力刑警 (日版)	Irem
mysticri	魔法警备队 铳法器 / Mystic Riders (世界版)	魔法警备队 铳法器 / Mystic Riders (世界版)	Irem
gunhohki	魔法警备队 铳法器 (日版)	魔法警备队 铳法器 (日版)	Irem
hook	铁钩船长 (世界版)	铁钩船长 (世界版)	Irem
hooku	铁钩船长 (美版)	铁钩船长 (美版)	Irem America
hookj	Hook (日版)	Hook (日版)	Irem
rtypeleo	龙神号 Leo / 异域战机 Leo (世界版)	龙神号 Leo / 异域战机 Leo (世界版)	Irem
rtypelej	龙神号 Leo / 异域战机 Leo (日版)	龙神号 Leo / 异域战机 Leo (日版)	Irem
inthunt	海底大战争 (世界版) 	海底大战争 (世界版) 	Irem
inthuntu	海底大战争 (美版)	海底大战争 (美版)	Irem America
kaiteids	海底大战争 (日版)	海底大战争 (日版)	Irem
nbbatman	忍者棒球 / Ninja Baseball Batman (美版)	忍者棒球 / Ninja Baseball Batman (美版)	Irem America
leaguemn	忍者棒球 / 棒球格斗 LeagueMan (日版)	忍者棒球 / 棒球格斗 LeagueMan (日版)	Irem
psoldier	完美战士 (日版)	完美战士 (日版)	Irem
dsccr94j	梦幻足球 '94 (日版)	梦幻足球 '94 (日版)	Irem
firebarr	火爆战机 (日版)	火爆战机 (日版)	Irem
dsoccr94	梦幻足球 '94	梦幻足球 '94	Irem (Data East Corporation license)
mplanets	疯狂星球	疯狂星球	Gottlieb
junglek	丛林求生记 / 丛林之王 (日版)	丛林求生记 / 丛林之王 (日版)	Taito Corporation
junglkj2	丛林求生记 / 丛林之王 (日版, earlier)	丛林求生记 / 丛林之王 (日版, earlier)	Taito Corporation
jungleh	丛林求生记 / 丛林猎手 (美版)	丛林求生记 / 丛林猎手 (美版)	Taito America Corporation
junglhbr	丛林求生记 / 丛林猎手 (巴西版)	丛林求生记 / 丛林猎手 (巴西版)	Taito do Brasil
alpine	高山滑雪 (set 1)	高山滑雪 (set 1)	Taito Corporation
alpinea	高山滑雪 (set 2)	高山滑雪 (set 2)	Taito Corporation
timetunl	时光隧道	时光隧道	Taito Corporation
wwestern	狂野西部 (set 1)	狂野西部 (set 1)	Taito Corporation
wwester1	狂野西部 (set 2)	狂野西部 (set 2)	Taito Corporation
frontlin	前线	前线	Taito Corporation
elevator	电梯大战	电梯大战	Taito Corporation
elevatob	电梯大战 (盗版)	电梯大战 (盗版)	bootleg
bioatack	生化攻击	生化攻击	Taito Corporation (Fox Video Games license)
sfposeid	海神战士	海神战士	Taito Corporation
crbaloon	疯狂气球 (set 1)	疯狂气球 (set 1)	Taito Corporation
crbalon2	疯狂气球 (set 2)	疯狂气球 (set 2)	Taito Corporation
gsword	击剑士	击剑士	Taito Corporation
lkage	影子传说	影子传说	Taito Corporation
lkageb	影子传说 (盗版 set 1)	影子传说 (盗版 set 1)	bootleg
lkageb2	影子传说 (盗版 set 2)	影子传说 (盗版 set 2)	bootleg
lkageb3	影子传说 (盗版 set 3)	影子传说 (盗版 set 3)	bootleg
retofinv	侵略者回归	侵略者回归	Taito Corporation
retofin1	侵略者回归 (盗版 set 1)	侵略者回归 (盗版 set 1)	bootleg
retofin2	侵略者回归 (盗版 set 2)	侵略者回归 (盗版 set 2)	bootleg
fieldday	运动会 / Field Day	运动会 / Field Day	Taito Corporation
undoukai	运动会 (日版)	运动会 (日版)	Taito Corporation
tsamurai	侍日本一 (set 1)	侍日本一 (set 1)	Taito
tsamura2	侍日本一 (set 2)	侍日本一 (set 2)	Taito
nunchaku	功夫少女	功夫少女	Taito
yamagchi	Go Go! 山口君	Go Go! 山口君	Taito
m660	660 任务 (美版)	660 任务 (美版)	[Woodplace Inc.] Taito America Corporation
m660j	660 任务 (日版)	660 任务 (日版)	[Woodplace Inc.] Taito Corporation
m660b	660 任务 (盗版)	660 任务 (盗版)	bootleg
flstory	仙境物语	仙境物语	Taito
flstoryj	仙境物语 (日版)	仙境物语 (日版)	Taito
onna34ro	女三四郎 / 飓风女孩 (set 1)	女三四郎 / 飓风女孩 (set 1)	Taito
onna34ra	女三四郎 / 飓风女孩 (set 2)	女三四郎 / 飓风女孩 (set 2)	Taito
gladiatr	黄金之城 / Gladiator (美版)	黄金之城 / Gladiator (美版)	Taito America Corporation
ogonsiro	黄金之城 (日版)	黄金之城 (日版)	Taito Corporation
halleys	哈雷彗星 (美版)	哈雷彗星 (美版)	Taito America Corporation (Coin-It license)
halleysc	哈雷彗星 (日版 set 1)	哈雷彗星 (日版 set 1)	Taito Corporation
halleycj	哈雷彗星 (日版 set 2)	哈雷彗星 (日版 set 2)	Taito Corporation
halley87	哈雷彗星 '87	哈雷彗星 '87	Taito Corporation
lsasquad	陆海空最前线 / Land Sea Air Squad	陆海空最前线 / Land Sea Air Squad	Taito
storming	陆海空最前线 / Storming Party	陆海空最前线 / Storming Party	Taito
tokio	轰炸东京 / Scramble Formation	轰炸东京 / Scramble Formation	Taito Corporation
tokiou	轰炸东京 / Scramble Formation (美版)	轰炸东京 / Scramble Formation (美版)	Taito America Corporation (Romstar license)
tokiob	轰炸东京 / Scramble Formation (盗版)	轰炸东京 / Scramble Formation (盗版)	bootleg
bublbobl	泡泡龙	泡泡龙	Taito Corporation
bublbob1	泡泡龙 (older)	泡泡龙 (older)	Taito Corporation
bublbobr	泡泡龙 (美版 有选择模式)	泡泡龙 (美版 有选择模式)	Taito America Corporation (Romstar license)
bubbobr1	泡泡龙 (美版)	泡泡龙 (美版)	Taito America Corporation (Romstar license)
boblbobl	泡泡龙	泡泡龙	bootleg
sboblbob	超级泡泡龙	超级泡泡龙	bootleg
bub68705	泡泡龙 (盗版 with 68705)	泡泡龙 (盗版 with 68705)	bootleg
kikikai	奇奇怪界	奇奇怪界	Taito Corporation
darius	太空战机 (世界版)	太空战机 (世界版)	Taito Corporation Japan
dariusj	太空战机 (日版)	太空战机 (日版)	Taito Corporation
dariuso	太空战机 (日版 old version)	太空战机 (日版 old version)	Taito Corporation
dariuse	太空战机 (特别版) (日版)	太空战机 (特别版) (日版)	Taito Corporation
topspeed	最高时速 (世界版)	最高时速 (世界版)	Taito Corporation Japan
topspedu	最高时速 (美版)	最高时速 (美版)	Taito America Corporation (Romstar license)
fullthrl	最高时速 (日版)	最高时速 (日版)	Taito Corporation
opwolf	野狼行动 (世界版)	野狼行动 (世界版)	Taito Corporation Japan
opwolfu	野狼行动 (美版)	野狼行动 (美版)	Taito America Corporation
opwolfb	野狼行动	野狼行动	bootleg
othunder	霹雳行动 (世界版)	霹雳行动 (世界版)	Taito Corporation Japan
othundu	霹雳行动 (美版)	霹雳行动 (美版)	Taito America Corporation
othunduo	霹雳行动 (美版, older)	霹雳行动 (美版, older)	Taito America Corporation
othundrj	霹雳行动 (日版)	霹雳行动 (日版)	Taito Corporation
rainbow	彩虹岛 (新版)	彩虹岛 (新版)	Taito Corporation
rainbowo	彩虹岛 (旧版)	彩虹岛 (旧版)	Taito Corporation
rainbowe	彩虹岛 (Extra)	彩虹岛 (Extra)	Taito Corporation
jumping	彩虹岛 / Jumping	彩虹岛 / Jumping	bootleg
arkanoid	打砖块 (世界版)	打砖块 (世界版)	Taito Corporation Japan
arknoidu	打砖块 (美版)	打砖块 (美版)	Taito America Corporation (Romstar license)
arknoiuo	打砖块 (美版, older)	打砖块 (美版, older)	Taito America Corporation (Romstar license)
arknoidj	打砖块 (日版)	打砖块 (日版)	Taito Corporation
arkmcubl	打砖块 (盗版单机片)	打砖块 (盗版单机片)	bootleg
ark1ball	打砖块 (盗版单机片, 困难)	打砖块 (盗版单机片, 困难)	bootleg
arkangc	打砖块 (游戏公司盗版, set 1)	打砖块 (游戏公司盗版, set 1)	bootleg
arkangc2	打砖块 (游戏公司盗版, set 2)	打砖块 (游戏公司盗版, set 2)	bootleg
arkblock	打砖块 (盗版, 日版)	打砖块 (盗版, 日版)	bootleg
arkbloc2	打砖块 (游戏公司盗版)	打砖块 (游戏公司盗版)	bootleg
arkgcbl	打砖块 (盗版底座)	打砖块 (盗版底座)	bootleg
paddle2	颤抖 2 (盗版底座)	颤抖 2 (盗版底座)	bootleg
arkatayt	打砖块 (Tayto 盗版, 日版)	打砖块 (Tayto 盗版, 日版)	bootleg
arktayt2	打砖块 (Tayto 盗版, 困难)	打砖块 (Tayto 盗版, 困难)	bootleg
arkatour	打砖块赛 (美版)	打砖块赛 (美版)	Taito America Corporation (Romstar license)
tetrsark	俄罗斯方块 (D.R. 韩国版)	俄罗斯方块 (D.R. 韩国版)	D.R. Korea
minivadr	迷你小蜜蜂	迷你小蜜蜂	Taito Corporation
bonzeadv	地狱小和尚 / Bonze Adventure (世界版)	地狱小和尚 / Bonze Adventure (世界版)	Taito Corporation Japan
bonzeadu	地狱小和尚 / Bonze Adventure (美版)	地狱小和尚 / Bonze Adventure (美版)	Taito America Corporation
jigkmgri	地狱小和尚 (日版)	地狱小和尚 (日版)	Taito Corporation
asuka	飞鸟 & 飞鸟 (日版)	飞鸟 & 飞鸟 (日版)	Taito Corporation
earthjkr	国联防卫军: 地球王牌 (日版)	国联防卫军: 地球王牌 (日版)	Visco
eto	古今东西干支物语 (日版)	古今东西干支物语 (日版)	Visco
wgp	国际机车大奖赛 (美版)	国际机车大奖赛 (美版)	Taito America Corporation
wgpj	国际机车大奖赛 (日版)	国际机车大奖赛 (日版)	Taito Corporation
wgpjoy	国际机车大奖赛 (joystick version set 1) (日版)	国际机车大奖赛 (joystick version set 1) (日版)	Taito Corporation
wgpjoya	国际机车大奖赛 (joystick version set 2) (日版)	国际机车大奖赛 (joystick version set 2) (日版)	Taito Corporation
wgp2	国际机车大奖赛 2 (日版)	国际机车大奖赛 2 (日版)	Taito Corporation
opwolf3	野狼行动 3 (世界版)	野狼行动 3 (世界版)	Taito Corporation Japan
opwolf3u	野狼行动 3 (美版)	野狼行动 3 (美版)	Taito America Corporation
ninjaw	忍者武士 (世界版)	忍者武士 (世界版)	Taito Corporation Japan
ninjawj	忍者武士 (日版)	忍者武士 (日版)	Taito Corporation
darius2	太空战机 II (日版)	太空战机 II (日版)	Taito Corporation
darius2d	太空战机 II (dual screen) (日版)	太空战机 II (dual screen) (日版)	Taito Corporation
drius2do	太空战机 II (dual screen) (日版 old version)	太空战机 II (dual screen) (日版 old version)	Taito Corporation
warriorb	武士之刃 - Rastan Saga Episode III (日版)	武士之刃 - Rastan Saga Episode III (日版)	Taito Corporation
superman	超人	超人	Taito Corporation
suprmanj	超人 (日版)	超人 (日版)	Taito Corporation
twinhawk	大旋风 / Twin Hawk (世界版)	大旋风 / Twin Hawk (世界版)	Taito Corporation Japan
twinhwku	大旋风 / Twin Hawk (美版)	大旋风 / Twin Hawk (美版)	Taito America Corporation
daisenpu	大旋风 (日版)	大旋风 (日版)	Taito Corporation
arknoid2	打砖块 - DOH 复仇 (世界版)	打砖块 - DOH 复仇 (世界版)	Taito Corporation Japan
arknid2u	打砖块 - DOH 复仇 (美版)	打砖块 - DOH 复仇 (美版)	Taito America Corporation (Romstar license)
arknid2j	打砖块 - DOH 复仇 (日版)	打砖块 - DOH 复仇 (日版)	Taito Corporation
drtoppel	Toppel 博士探险队 (世界版)	Toppel 博士探险队 (世界版)	Taito Corporation Japan
drtopplu	Toppel 博士探险队 (美版)	Toppel 博士探险队 (美版)	Taito America Corporation
drtopplj	Toppel 博士探险队 (日版)	Toppel 博士探险队 (日版)	Taito Corporation
kageki	火激 (美版)	火激 (美版)	Taito America Corporation (Romstar license)
kagekij	火激 (日版)	火激 (日版)	Taito Corporation
kagekia	火激 (世界版?, hack)	火激 (世界版?, hack)	Taito Corporation
chukatai	中华大仙 (世界版)	中华大仙 (世界版)	Taito Corporation Japan
chukatau	中华大仙 (美版)	中华大仙 (美版)	Taito America Corporation
chukataj	中华大仙 (日版)	中华大仙 (日版)	Taito Corporation
tnzs	小鸡尼泽的故事 (日版)	小鸡尼泽的故事 (日版)	Taito Corporation Japan
tnzsj	小鸡尼泽的故事 (日版)	小鸡尼泽的故事 (日版)	Taito Corporation
tnzso	小鸡尼泽的故事 (世界版, older)	小鸡尼泽的故事 (世界版, older)	Taito Corporation Japan
kurikint	功里金团 (世界版)	功里金团 (世界版)	Taito Corporation Japan
kurikinu	功里金团 (美版)	功里金团 (美版)	Taito America Corporation
kurikinj	功里金团 (日版)	功里金团 (日版)	Taito Corporation
kurikina	功里金团 (世界版, 工程版?)	功里金团 (世界版, 工程版?)	Taito Corporation Japan
fhawk	战斗猎鹰 (世界版)	战斗猎鹰 (世界版)	Taito Corporation Japan
fhawkj	战斗猎鹰 (日版)	战斗猎鹰 (日版)	Taito Corporation
champwr	冠军摔跤 (世界版)	冠军摔跤 (世界版)	Taito Corporation Japan
champwru	冠军摔跤 (美版)	冠军摔跤 (美版)	Taito America Corporation
champwrj	冠军摔跤 (日版)	冠军摔跤 (日版)	Taito Corporation
dleague	震撼联盟 (日版)	震撼联盟 (日版)	Taito Corporation
rambo3	兰博 III (欧洲版 set 1)	兰博 III (欧洲版 set 1)	Taito Europe Corporation
rambo3ae	兰博 III (欧洲版 set 2)	兰博 III (欧洲版 set 2)	Taito Europe Corporation
rambo3a	兰博 III (美版)	兰博 III (美版)	Taito America Corporation
crimec	罪恶都市 (世界版)	罪恶都市 (世界版)	Taito Corporation Japan
crimecu	罪恶都市 (美版)	罪恶都市 (美版)	Taito America Corporation
crimecj	罪恶都市 (日版)	罪恶都市 (日版)	Taito Corporation
tetrist	俄罗斯方块 (日版, B-System)	俄罗斯方块 (日版, B-System)	Sega
tetrista	俄罗斯方块 (日版, B-System, YM2203)	俄罗斯方块 (日版, B-System, YM2203)	Sega
viofight	暴力格斗 (世界版)	暴力格斗 (世界版)	Taito Corporation Japan
viofighu	暴力格斗 (美版)	暴力格斗 (美版)	Taito America Corporation
ashura	阿修罗风暴 (日版)	阿修罗风暴 (日版)	Taito Corporation
ashurau	阿修罗风暴 (美版)	阿修罗风暴 (美版)	Taito America Corporation
silentd	沉默之龙 (世界版)	沉默之龙 (世界版)	Taito Corporation Japan
silentdu	沉默之龙 (美版)	沉默之龙 (美版)	Taito America Corporation
silentdj	沉默之龙 (日版)	沉默之龙 (日版)	Taito Corporation
ryujin	龙神 (日版)	龙神 (日版)	Taito Corporation
qzshowby	问答世界 Show by Show by!! (日版)	问答世界 Show by Show by!! (日版)	Taito Corporation
pbobble	泡泡龙 (日版, B-System)	泡泡龙 (日版, B-System)	Taito Corporation
spacedx	宇宙侵略者 DX (美版) v2.1	宇宙侵略者 DX (美版) v2.1	Taito Corporation
spacedxj	宇宙侵略者 DX (日版) v2.1	宇宙侵略者 DX (日版) v2.1	Taito Corporation
spacedxo	宇宙侵略者 DX (日版) v2.0	宇宙侵略者 DX (日版) v2.0	Taito Corporation
nightstr	午夜出击 (美版)	午夜出击 (美版)	Taito America Corporation
sci	S.C.I. / 特别刑事调查组 (世界版 set 1)	S.C.I. / 特别刑事调查组 (世界版 set 1)	Taito Corporation Japan
scia	S.C.I. / 特别刑事调查组 (世界版 set 2)	S.C.I. / 特别刑事调查组 (世界版 set 2)	Taito Corporation Japan
sciu	S.C.I. / 特别刑事调查组 (美版)	S.C.I. / 特别刑事调查组 (美版)	Taito America Corporation
bshark	猎鲨行动 (美版)	猎鲨行动 (美版)	Taito America Corporation
bsharkj	猎鲨行动 (日版)	猎鲨行动 (日版)	Taito Corporation
dblaxle	四驱赛车 (美版)	四驱赛车 (美版)	Taito America Corporation
pwheelsj	四驱赛车 (日版)	四驱赛车 (日版)	Taito Corporation
superchs	大追捕 - 罪恶终结者 (美版)	大追捕 - 罪恶终结者 (美版)	Taito America Corporation
finalb	最终打击 (世界版)	最终打击 (世界版)	Taito Corporation Japan
finalbj	最终打击 (日版)	最终打击 (日版)	Taito Corporation
finalbu	最终打击 (美版)	最终打击 (美版)	Taito America Corporation
thundfox	雷狐战士 (世界版)	雷狐战士 (世界版)	Taito Corporation Japan
thndfoxu	雷狐战士 (美版)	雷狐战士 (美版)	Taito America Corporation
thndfoxj	雷狐战士 (日版)	雷狐战士 (日版)	Taito Corporation
qtorimon	苦胃头捕物帐 (日版)	苦胃头捕物帐 (日版)	Taito Corporation
liquidk	Baku 女士大冒险 / 水之精灵 (世界版)	Baku 女士大冒险 / 水之精灵 (世界版)	Taito Corporation Japan
liquidku	Baku 女士大冒险 / 水之精灵 (美版)	Baku 女士大冒险 / 水之精灵 (美版)	Taito America Corporation
mizubaku	Baku 女士大冒险 (日版)	Baku 女士大冒险 (日版)	Taito Corporation
quizhq	问答大本营 (日版)	问答大本营 (日版)	Taito Corporation
ssi	超级宇宙侵略者 '91 (世界版)	超级宇宙侵略者 '91 (世界版)	Taito Corporation Japan
majest12	超级宇宙侵略者 / Majestic Twelve - 宇宙侵略者 Part IV (日版)	超级宇宙侵略者 / Majestic Twelve - 宇宙侵略者 Part IV (日版)	Taito Corporation
gunfront	枪之国度 (世界版)	枪之国度 (世界版)	Taito Corporation Japan
gunfronj	枪之国度 (日版)	枪之国度 (日版)	Taito Corporation
growl	森林保护神 (世界版)	森林保护神 (世界版)	Taito Corporation Japan
growlu	森林保护神 (美版)	森林保护神 (美版)	Taito America Corporation
mjnquest	麻雀探险 (日版)	麻雀探险 (日版)	Taito Corporation
mjnquesb	麻雀探险 (非脱衣版)	麻雀探险 (非脱衣版)	Taito Corporation
koshien	呜呼荣光甲子园 (日版)	呜呼荣光甲子园 (日版)	Taito Corporation
ninjak	忍者: 布娃娃迷你版 (世界版)	忍者: 布娃娃迷你版 (世界版)	Taito Corporation Japan
ninjakj	忍者: 布娃娃迷你版 (日版)	忍者: 布娃娃迷你版 (日版)	Taito Corporation
ninjaku	忍者: 布娃娃迷你版 (美版)	忍者: 布娃娃迷你版 (美版)	Taito America Corporation
qzquest	问答搜查 - 英雄美女物语 (日版)	问答搜查 - 英雄美女物语 (日版)	Taito Corporation
metalb	黑色合金 / Metal Black (世界版)	黑色合金 / Metal Black (世界版)	Taito Corporation Japan
metalbj	黑色合金 / Metal Black (日版)	黑色合金 / Metal Black (日版)	Taito Corporation
qzchikyu	问答 地球防卫军 (日版)	问答 地球防卫军 (日版)	Taito Corporation
yesnoj	Yes/No 心电图	Yes/No 心电图	Taito Corporation
deadconx	死亡边缘 (世界版)	死亡边缘 (世界版)	Taito Corporation Japan
deadconj	死亡边缘 (日版)	死亡边缘 (日版)	Taito Corporation
dinorex	大恐龙格斗技传说 (世界版)	大恐龙格斗技传说 (世界版)	Taito Corporation Japan
dinorexj	大恐龙格斗技传说 (日版)	大恐龙格斗技传说 (日版)	Taito Corporation
dinorexu	大恐龙格斗技传说 (美版)	大恐龙格斗技传说 (美版)	Taito America Corporation
qjinsei	问答 人生剧场 (日版)	问答 人生剧场 (日版)	Taito Corporation
arabianm	阿拉伯魔法 (Ver 1.0O 1992/07/06)	阿拉伯魔法 (Ver 1.0O 1992/07/06)	Taito Corporation Japan
arabiamj	阿拉伯魔法 (Ver 1.0J 1992/07/06)	阿拉伯魔法 (Ver 1.0J 1992/07/06)	Taito Corporation
arabiamu	阿拉伯魔法 (Ver 1.0A 1992/07/06)	阿拉伯魔法 (Ver 1.0A 1992/07/06)	Taito America Corporation
lightbr	光明力量 (Ver 2.1J 1994/02/18)	光明力量 (Ver 2.1J 1994/02/18)	Taito Corporation
kaiserkn	断仇牙 / 王者铁拳 (Ver 2.1O 1994/07/29)	断仇牙 / 王者铁拳 (Ver 2.1O 1994/07/29)	Taito Corporation Japan
kaiserkj	断仇牙 / 王者铁拳 (Ver 2.1J 1994/07/29)	断仇牙 / 王者铁拳 (Ver 2.1J 1994/07/29)	Taito Corporation
gblchmp	断仇牙 / 王者铁拳 (美版)	断仇牙 / 王者铁拳 (美版)	Taito America Corporation
dankuga	断仇牙 (工程版)	断仇牙 (工程版)	Taito Corporation
dariusg	太空战机外传 - 银鹰 (世界版)	太空战机外传 - 银鹰 (世界版)	Taito Corporation Japan
dariusgj	太空战机外传 - 银鹰 (日版)	太空战机外传 - 银鹰 (日版)	Taito Corporation
dariusgu	太空战机外传 - 银鹰 (美版)	太空战机外传 - 银鹰 (美版)	Taito America Corporation
dariusgx	太空战机外传 - 银鹰 (特别版) [官方 Hack]	太空战机外传 - 银鹰 (特别版) [官方 Hack]	Taito Corporation
bublbob2	泡泡龙 2 (世界版)	泡泡龙 2 (世界版)	Taito Corporation Japan
bubsympe	泡泡龙: 交响乐 (欧洲版)	泡泡龙: 交响乐 (欧洲版)	Taito Corporation Japan
bubsympu	泡泡龙: 交响乐 (美版)	泡泡龙: 交响乐 (美版)	Taito America Corporation
bubsymph	泡泡龙: 交响乐 (日版)	泡泡龙: 交响乐 (日版)	Taito Corporation
spcinvdj	宇宙侵略者 DX (日版 F3 version)	宇宙侵略者 DX (日版 F3 version)	Taito Corporation
qtheater	问答 剧场 - 第 3 物语- (Ver 2.3J 1994/11/10)	问答 剧场 - 第 3 物语- (Ver 2.3J 1994/11/10)	Taito Corporation
elvactr	电梯大战 2 (Ver 2.2O 1995/02/20)	电梯大战 2 (Ver 2.2O 1995/02/20)	Taito Corporation Japan
elvactrj	电梯大战 2 (Ver 2.2J 1995/02/20)	电梯大战 2 (Ver 2.2J 1995/02/20)	Taito Corporation
elvact2u	电梯大战 2 (Ver 2.2A 1995/02/20)	电梯大战 2 (Ver 2.2A 1995/02/20)	Taito America Corporation
quizhuhu	森口博子问答 (日版)	森口博子问答 (日版)	Taito Corporation
pbobble2	泡泡龙 2 (世界版)	泡泡龙 2 (世界版)	Taito Corporation Japan
pbobbl2j	泡泡龙 2 (日版)	泡泡龙 2 (日版)	Taito Corporation
pbobbl2u	泡泡龙 2 / Bust-A-Move Again (美版)	泡泡龙 2 / Bust-A-Move Again (美版)	Taito America Corporation
pbobbl2x	泡泡龙 2X (日版)	泡泡龙 2X (日版)	Taito Corporation
gekirido	逆鳞弹 (Ver 2.3J 1995/09/21)	逆鳞弹 (Ver 2.3J 1995/09/21)	Taito Corporation
ktiger2	究极虎 2 (Ver 2.1J 1995/11/30)	究极虎 2 (Ver 2.1J 1995/11/30)	Taito Corporation
bubblem	泡泡的记忆 - The Story Of Bubble Bobble 3 (世界版)	泡泡的记忆 - The Story Of Bubble Bobble 3 (世界版)	Taito Corporation Japan
bubblemj	泡泡的记忆 - The Story Of Bubble Bobble 3 (日版)	泡泡的记忆 - The Story Of Bubble Bobble 3 (日版)	Taito Corporation
pbobble3	泡泡龙 3 (世界版)	泡泡龙 3 (世界版)	Taito Corporation
pbobbl3u	泡泡龙 3 (美版)	泡泡龙 3 (美版)	Taito Corporation
pbobbl3j	泡泡龙 3 (日版)	泡泡龙 3 (日版)	Taito Corporation
arkretrn	打砖块 Returns (日版)	打砖块 Returns (日版)	Taito Corporation
pbobble4	泡泡龙 4 (世界版)	泡泡龙 4 (世界版)	Taito Corporation
pbobbl4j	泡泡龙 4 (日版)	泡泡龙 4 (日版)	Taito Corporation
pbobbl4u	泡泡龙 4 (美版)	泡泡龙 4 (美版)	Taito Corporation
tigerh	老虎直升机 (美版)	老虎直升机 (美版)	Taito America Corp.
tigerh2	老虎直升机 (日版 set 1)	老虎直升机 (日版 set 1)	Taito Corp.
tigerhj	老虎直升机 (日版 set 2)	老虎直升机 (日版 set 2)	Taito Corp.
tigerhb1	老虎直升机 (盗版 set 1)	老虎直升机 (盗版 set 1)	bootleg
tigerhb2	老虎直升机 (盗版 set 2)	老虎直升机 (盗版 set 2)	bootleg
mjsister	麻雀姐妹 (日版)	麻雀姐妹 (日版)	Toaplan
fshark	飞翔鲛 / Flying Shark (世界版)	飞翔鲛 / Flying Shark (世界版)	[Toaplan] Taito Corporation
skyshark	飞翔鲛 / Sky Shark (美版)	飞翔鲛 / Sky Shark (美版)	[Toaplan] Taito America Corporation (Romstar license)
hishouza	飞翔鲛 (日版)	飞翔鲛 (日版)	[Toaplan] Taito Corporation
fsharkbt	飞翔鲛 / Flying Shark (盗版)	飞翔鲛 / Flying Shark (盗版)	bootleg
wardner	Wardner 森林 (世界版)	Wardner 森林 (世界版)	[Toaplan] Taito Corporation Japan
pyros	Wardner 森林 / Pyros (美版)	Wardner 森林 / Pyros (美版)	[Toaplan] Taito America Corporation
wardnerj	Wardner 森林 (日版)	Wardner 森林 (日版)	[Toaplan] Taito Corporation
twincobr	究极虎 / Twin Cobra (世界版)	究极虎 / Twin Cobra (世界版)	[Toaplan] Taito Corporation
twincobu	究极虎 / Twin Cobra (美版)	究极虎 / Twin Cobra (美版)	[Toaplan] Taito America Corporation (Romstar license)
ktiger	究极虎 (日版)	究极虎 (日版)	[Toaplan] Taito Corporation
rallybik	拉力摩托 / 冲刺野郎	拉力摩托 / 冲刺野郎	[Toaplan] Taito Corporation
truxton	达人 / Truxton	达人 / Truxton	[Toaplan] Taito Corporation
hellfire	地狱火	地狱火	Toaplan (Taito license)
hellfir1	地狱火 (1P Ver.)	地狱火 (1P Ver.)	Toaplan (Taito license)
hellfir2	地狱火 (2P Ver., first edition)	地狱火 (2P Ver., first edition)	Toaplan (Taito license)
zerowing	零式战机	零式战机	Toaplan
fireshrk	鲛! 鲛! 鲛! / Fire Shark	鲛! 鲛! 鲛! / Fire Shark	Toaplan
samesame	鲛! 鲛! 鲛!	鲛! 鲛! 鲛!	Toaplan
samesam2	鲛! 鲛! 鲛! (2P Ver.)	鲛! 鲛! 鲛! (2P Ver.)	Toaplan
outzone	异域战将 (set 1)	异域战将 (set 1)	Toaplan
outzonea	异域战将 (set 2)	异域战将 (set 2)	Toaplan
outzoneb	异域战将 (set 3, 工程版?)	异域战将 (set 3, 工程版?)	Toaplan
outzonec	异域战将 (set 4)	异域战将 (set 4)	Toaplan
vimana	银河战机	银河战机	Toaplan
vimana1	银河战机 (old set)	银河战机 (old set)	Toaplan
vimanan	银河战机 (Nova Apparate GMBH & Co)	银河战机 (Nova Apparate GMBH & Co)	Toaplan (Nova Apparate GMBH & Co license)
snowbros	雪人兄弟 - Nick & Tom (set 1)	雪人兄弟 - Nick & Tom (set 1)	Toaplan
snowbroa	雪人兄弟 - Nick & Tom (set 2)	雪人兄弟 - Nick & Tom (set 2)	Toaplan
snowbrob	雪人兄弟 - Nick & Tom (set 3)	雪人兄弟 - Nick & Tom (set 3)	Toaplan
snowbroc	雪人兄弟 - Nick & Tom (set 4)	雪人兄弟 - Nick & Tom (set 4)	Toaplan
snowbroj	雪人兄弟 - Nick & Tom (日版)	雪人兄弟 - Nick & Tom (日版)	Toaplan
wintbob	雪人兄弟 / The Winter Bobble	雪人兄弟 / The Winter Bobble	bootleg
3in1semi	3 合 1 (SemiCom)	3 合 1 (SemiCom)	SemiCom
snowbro3	雪人兄弟 3 - 神奇的冒险	雪人兄弟 3 - 神奇的冒险	Syrmex (bootleg/hack)
finalttr	最终俄罗斯方块	最终俄罗斯方块	Jeil Computer System
truxton2	达人 II / 达人王 / Truxton II (日版)	达人 II / 达人王 / Truxton II (日版)	Toaplan
pipibibs	皮皮与比比	皮皮与比比	Toaplan
whoopee	皮皮与比比	皮皮与比比	Toaplan
pipibibi	皮皮与比比 (盗版 ?)	皮皮与比比 (盗版 ?)	[Toaplan] Ryouta Kikaku
batsugun	疯狂枪支 (set 1)	疯狂枪支 (set 1)	Toaplan
batsugna	疯狂枪支 (set 2)	疯狂枪支 (set 2)	Toaplan
batugnsp	疯狂枪支 (特别版.)	疯狂枪支 (特别版.)	Toaplan
snowbro2	雪人兄弟 2 - 天国 / With New Elves	雪人兄弟 2 - 天国 / With New Elves	[Toaplan] Hanafram
mahoudai	魔法大作战 (日版)	魔法大作战 (日版)	Raizing (Able license)
shippumd	疾风魔法大作战 - 王国大赏 (日版)	疾风魔法大作战 - 王国大赏 (日版)	Raizing / Eighting
kingdmgp	疾风魔法大作战 - 王国大赏 (世界)	疾风魔法大作战 - 王国大赏 (世界)	Raizing / Eighting
batrider	防卫厅之战警们 (日版, version B)	防卫厅之战警们 (日版, version B)	Raizing / Eighting
batridra	防卫厅之战警们 (日版, version A)	防卫厅之战警们 (日版, version A)	Raizing / Eighting
batridrk	防卫厅之战警们 (韩国版, version B)	防卫厅之战警们 (韩国版, version B)	Raizing / Eighting
pwrinst2	豪血寺一族 2 (美版)	豪血寺一族 2 (美版)	Atlus/Cave
pwrins2j	豪血寺一族 2 (日版)	豪血寺一族 2 (日版)	Atlus/Cave
plegends	豪血寺一族外传 最强传说 (美版)	豪血寺一族外传 最强传说 (美版)	Atlus/Cave
plegendj	豪血寺一族外传 最强传说 (日版)	豪血寺一族外传 最强传说 (日版)	Atlus/Cave
mazinger	铁甲万能侠 / Z 大魔神	铁甲万能侠 / Z 大魔神	Banpresto/Dynamic Pl. Toei Animation
donpachi	首领蜂 (美版)	首领蜂 (美版)	Atlus/Cave
donpacjp	首领蜂 (日版)	首领蜂 (日版)	Atlus/Cave
donpackr	首领蜂 (韩国版)	首领蜂 (韩国版)	Atlus/Cave
donpachk	首领蜂 (韩国版)	首领蜂 (韩国版)	Atlus/Cave
metmqstr	隐忍 - The Ninja Master / Metamoqester	隐忍 - The Ninja Master / Metamoqester	Banpresto/Pandorabox
nmaster	Oni-忍者主人	Oni-忍者主人	Banpresto/Pandorabox
sailormn	美少女战士 - 水手月亮 (95/03/22B)	美少女战士 - 水手月亮 (95/03/22B)	Banpresto
sailormo	美少女战士 - 水手月亮 (95/03/22)	美少女战士 - 水手月亮 (95/03/22)	Banpresto
agallet	石破天惊 / Air Gallet	石破天惊 / Air Gallet	Banpresto / Gazelle
hotdogst	眩之风暴	眩之风暴	Marble
ddonpach	怒首领蜂 (国际版)	怒首领蜂 (国际版)	Atlus/Cave
ddonpchj	怒首I蜂 (日版)	怒首I蜂 (日版)	Atlus/Cave
dfeveron	弹铳 Feveron (日版)	弹铳 Feveron (日版)	Cave (Nihon System license)
feversos	弹铳 Feveron (日版)	弹铳 Feveron (日版)	Cave (Nihon System license)
esprade	长空超少年 / ESP Ra.De. (国际版 Ver 1998 4/22)	长空超少年 / ESP Ra.De. (国际版 Ver 1998 4/22)	Atlus/Cave
espradej	长空超少年 / ESP Ra.De. (日版 Ver 1998 4/21)	长空超少年 / ESP Ra.De. (日版 Ver 1998 4/21)	Atlus/Cave
espradeo	长空超少年 / ESP Ra.De. (日版 Ver 1998 4/14)	长空超少年 / ESP Ra.De. (日版 Ver 1998 4/14)	Atlus/Cave
uopoko	小猫钓鱼 (国际版)	小猫钓鱼 (国际版)	Cave (Jaleco license)
uopokoj	小猫钓鱼 (日版)	小猫钓鱼 (日版)	Cave (Jaleco license)
guwange	狱门山物语 / Guwange (日版)	狱门山物语 / Guwange (日版)	Atlus/Cave
gaia	征战者	征战者	Noise Factory
theroes	霹雳英雄	霹雳英雄	Primetek Investments
korokoro	Koro Koro 问答 (日版)	Koro Koro 问答 (日版)	Takumi
sonofphx	凤凰之子	凤凰之子	Associated Overseas MFR, Inc
srdmissn	S.R.D.任务	S.R.D.任务	Taito Corporation
airwolf	天狼	天狼	Kyugo
skywolf	空狼 (set 1)	空狼 (set 1)	bootleg
skywolf2	空狼 (set 2)	空狼 (set 2)	bootleg
sonson	西游记	西游记	Capcom
sonsonj	西游记 (日版)	西游记 (日版)	Capcom
commando	战场之狼 / 突击队 (世界版)	战场之狼 / 突击队 (世界版)	Capcom
commandu	战场之狼 / 突击队 (美版)	战场之狼 / 突击队 (美版)	Capcom (Data East USA license)
commandj	战场之狼	战场之狼	Capcom
commandb	战场之狼 (盗版)	战场之狼 (盗版)	bootleg
sinvasn	战场之狼 / 领域侵犯 (欧洲版)	战场之狼 / 领域侵犯 (欧洲版)	Capcom
sinvasnb	战场之狼 / 领域侵犯 (盗版)	战场之狼 / 领域侵犯 (盗版)	bootleg
gng	魔界村 / Ghosts'n Goblins (世界版? set 1)	魔界村 / Ghosts'n Goblins (世界版? set 1)	Capcom
gnga	魔界村 / Ghosts'n Goblins (世界版? set 2)	魔界村 / Ghosts'n Goblins (世界版? set 2)	Capcom
gngt	魔界村 / Ghosts'n Goblins (美版)	魔界村 / Ghosts'n Goblins (美版)	Capcom (Taito America license)
makaimur	魔界村 (日版)	魔界村 (日版)	Capcom
makaimuc	魔界村 (日版 Revision C)	魔界村 (日版 Revision C)	Capcom
makaimug	魔界村 (日版 Revision G)	魔界村 (日版 Revision G)	Capcom
diamond	Diamond Run	Diamond Run	KH Video
gunsmoke	荒野大镖客 (世界版)	荒野大镖客 (世界版)	Capcom
gunsmoku	荒野大镖客 (美版 set 1)	荒野大镖客 (美版 set 1)	Capcom (Romstar license)
gunsmoka	荒野大镖客 (美版 set 2)	荒野大镖客 (美版 set 2)	Capcom (Romstar license)
gunsmokj	荒野大镖客 (日版)	荒野大镖客 (日版)	Capcom
trojan	斗者挽歌 / Trojan (美版)	斗者挽歌 / Trojan (美版)	Capcom
trojanr	斗者挽歌 / Trojan (Romstar)	斗者挽歌 / Trojan (Romstar)	Capcom (Romstar license)
trojanj	斗者挽歌 (日版)	斗者挽歌 (日版)	Capcom
lwings	翼人 / Legendary Wings (美版 set 1)	翼人 / Legendary Wings (美版 set 1)	Capcom
lwings2	翼人 / Legendary Wings (美版 set 2)	翼人 / Legendary Wings (美版 set 2)	Capcom
lwingsjp	翼人 (日版)	翼人 (日版)	Capcom
avengers	必杀! 无赖拳 (美版 set 1)	必杀! 无赖拳 (美版 set 1)	Capcom
avenger2	必杀! 无赖拳 (美版 set 2)	必杀! 无赖拳 (美版 set 2)	Capcom
buraiken	必杀! 无赖拳 (日版)	必杀! 无赖拳 (日版)	Capcom
bionicc	希魔复活 / 生化指令 (美版 set 1)	希魔复活 / 生化指令 (美版 set 1)	Capcom
bionicc1	生化指令 (美版 set 1)	生化指令 (美版 set 1)	Capcom
bionicc2	生化指令 (美版 set 2)	生化指令 (美版 set 2)	Capcom
topsecrt	最高机密 (日版)	最高机密 (日版)	Capcom
1943	1943 - 中途岛海战 (美版)	1943 - 中途岛海战 (美版)	Capcom
1943j	1943 - 中途岛海战 (日版)	1943 - 中途岛海战 (日版)	Capcom
blktiger	暗黑之虎	暗黑之虎	Capcom
bktigerb	暗黑之虎 (盗版)	暗黑之虎 (盗版)	bootleg
blkdrgon	暗黑之龙	暗黑之龙	Capcom
blkdrgnb	暗黑之龙 (盗版)	暗黑之龙 (盗版)	bootleg
sf	街头霸王 (世界版)	街头霸王 (世界版)	Capcom
sfus	街头霸王 (美版)	街头霸王 (美版)	Capcom
sfjp	街头霸王 (日版)	街头霸王 (日版)	Capcom
sfp	街头霸王 (工程版)	街头霸王 (工程版)	Capcom
tigeroad	虎之道 (美版)	虎之道 (美版)	Capcom (Romstar license)
toramich	虎之道 (日版)	虎之道 (日版)	Capcom
tigerodb	虎之道 (美版 盗版)	虎之道 (美版 盗版)	bootleg
f1dream	F-1 之梦	F-1 之梦	Capcom (Romstar license)
f1dreamb	F-1 之梦 (盗版)	F-1 之梦 (盗版)	bootleg
1943kai	1943 改 - 中途岛海战 (日版)	1943 改 - 中途岛海战 (日版)	Capcom
lastduel	最后之星 (美版 set 1)	最后之星 (美版 set 1)	Capcom
lstduela	决战 (美版 set 2)	决战 (美版 set 2)	Capcom
lstduelb	决战 (盗版)	决战 (盗版)	bootleg
madgear	疯狂机车 (美版)	疯狂机车 (美版)	Capcom
madgearj	疯狂机车 (日版)	疯狂机车 (日版)	Capcom
ledstorm	疯狂机车 / Led Storm (美版)	疯狂机车 / Led Storm (美版)	Capcom
forgottn	失落的世界 (美版)	失落的世界 (美版)	Capcom
lostwrld	失落的世界 (日版)	失落的世界 (日版)	Capcom
ghouls	大魔界村 (世界版)	大魔界村 (世界版)	Capcom
ghoulsu	大魔界村 (美版)	大魔界村 (美版)	Capcom
daimakai	大魔界村 (日版)	大魔界村 (日版)	Capcom
strider	出击飞龙 (美版 set 1)	出击飞龙 (美版 set 1)	Capcom
stridrua	出击飞龙 (美版 set 2)	出击飞龙 (美版 set 2)	Capcom
striderj	出击飞龙 (日版 set 1)	出击飞龙 (日版 set 1)	Capcom
stridrja	出击飞龙 (日版 set 2)	出击飞龙 (日版 set 2)	Capcom
dynwar	吞食天地 / 王朝战争 (世界版)	吞食天地 / 王朝战争 (世界版)	Capcom
dynwarj	吞食天地 (日版)	吞食天地 (日版)	Capcom
willow	Willow (美版)	Willow (美版)	Capcom
willowj	Willow (日版, 日本语)	Willow (日版, 日本语)	Capcom
willowje	Willow (日版, 英语)	Willow (日版, 英语)	Capcom
unsquad	战区 88 / 联合国空战队 (美版)	战区 88 / 联合国空战队 (美版)	Capcom
area88	战区 88 (日版)	战区 88 (日版)	Capcom
ffight	快打旋风 (世界版)	快打旋风 (世界版)	Capcom
ffightu	快打旋风 (美版 900112)	快打旋风 (美版 900112)	Capcom
ffightua	快打旋风 (美版 900613)	快打旋风 (美版 900613)	Capcom
ffightj	快打旋风 (日版)	快打旋风 (日版)	Capcom
ffightj1	快打旋风 (日版 900305)	快打旋风 (日版 900305)	Capcom
1941	1941 - 反击战 (世界版)	1941 - 反击战 (世界版)	Capcom
1941j	1941 - 反击战 (日版)	1941 - 反击战 (日版)	Capcom
mercs	战场之狼 II / Mercs (世界版 900302)	战场之狼 II / Mercs (世界版 900302)	Capcom
mercsu	战场之狼 II / Mercs (美版 900302)	战场之狼 II / Mercs (美版 900302)	Capcom
mercsua	战场之狼 II / Mercs (美版 900608)	战场之狼 II / Mercs (美版 900608)	Capcom
mercsj	战场之狼 II (日版 900302)	战场之狼 II (日版 900302)	Capcom
mtwins	双麟儿 / 魔法男孩 / Mega Twins (世界版 900619)	双麟儿 / 魔法男孩 / Mega Twins (世界版 900619)	Capcom
chikij	双麟儿 / 魔法男孩 (日版 900619)	双麟儿 / 魔法男孩 (日版 900619)	Capcom
msword	魔法剑 - 英雄的幻想 (世界版 900725)	魔法剑 - 英雄的幻想 (世界版 900725)	Capcom
mswordr1	魔法剑 - 英雄的幻想 (世界版 900623)	魔法剑 - 英雄的幻想 (世界版 900623)	Capcom
mswordu	魔法剑 - 英雄的幻想 (美版 900725)	魔法剑 - 英雄的幻想 (美版 900725)	Capcom
mswordj	魔法剑 (日版 900623)	魔法剑 (日版 900623)	Capcom
cawing	雌虎战机 / 美国海军 / Carrier Air Wing (世界版 901012)	雌虎战机 / 美国海军 / Carrier Air Wing (世界版 901012)	Capcom
cawingr1	雌虎战机 / 美国海军 / Carrier Air Wing (世界版 901009)	雌虎战机 / 美国海军 / Carrier Air Wing (世界版 901009)	Capcom
cawingu	雌虎战机 / 美国海军 / Carrier Air Wing (美版 901012)	雌虎战机 / 美国海军 / Carrier Air Wing (美版 901012)	Capcom
cawingj	雌虎战机 / 美国海军 / Carrier Air Wing (日版 901012)	雌虎战机 / 美国海军 / Carrier Air Wing (日版 901012)	Capcom
nemo	梦幻冒险 (世界版 901130)	梦幻冒险 (世界版 901130)	Capcom
nemoj	梦幻冒险 (日版 901120)	梦幻冒险 (日版 901120)	Capcom
sf2	街头霸王 II - 天下斗士 (世界版 910522)	街头霸王 II - 天下斗士 (世界版 910522)	Capcom
sf2eb	街头霸王 II - 天下斗士 (世界版 910214)	街头霸王 II - 天下斗士 (世界版 910214)	Capcom
sf2ua	街头霸王 II - 天下斗士 (美版 910206)	街头霸王 II - 天下斗士 (美版 910206)	Capcom
sf2ub	街头霸王 II - 天下斗士 (美版 910214)	街头霸王 II - 天下斗士 (美版 910214)	Capcom
sf2ud	街头霸王 II - 天下斗士 (美版 910318)	街头霸王 II - 天下斗士 (美版 910318)	Capcom
sf2ue	街头霸王 II - 天下斗士 (美版 910228)	街头霸王 II - 天下斗士 (美版 910228)	Capcom
sf2uf	街头霸王 II - 天下斗士 (美版 910411)	街头霸王 II - 天下斗士 (美版 910411)	Capcom
sf2ui	街头霸王 II - 天下斗士 (美版 910522)	街头霸王 II - 天下斗士 (美版 910522)	Capcom
sf2uk	街头霸王 II - 天下斗士 (美版 911101)	街头霸王 II - 天下斗士 (美版 911101)	Capcom
sf2j	街头霸王 II - 天下斗士 (日版 911210)	街头霸王 II - 天下斗士 (日版 911210)	Capcom
sf2ja	街头霸王 II - 天下斗士 (日版 910214)	街头霸王 II - 天下斗士 (日版 910214)	Capcom
sf2jc	街头霸王 II - 天下斗士 (日版 910306)	街头霸王 II - 天下斗士 (日版 910306)	Capcom
3wonders	奇迹 3 合 1 (世界版 910520)	奇迹 3 合 1 (世界版 910520)	Capcom
3wonderu	奇迹 3 合 1 (美版 910520)	奇迹 3 合 1 (美版 910520)	Capcom
wonder3	奇迹 3 合 1 (日版 910520)	奇迹 3 合 1 (日版 910520)	Capcom
kod	龙王战士 (世界版 910711)	龙王战士 (世界版 910711)	Capcom
kodu	龙王战士 (美版 910910)	龙王战士 (美版 910910)	Capcom
kodj	龙王战士 (日版 910805)	龙王战士 (日版 910805)	Capcom
kodb	龙王战士 (盗版)	龙王战士 (盗版)	bootleg
captcomm	名将 (世界版 911014)	名将 (世界版 911014)	Capcom
captcomu	名将 (美版 910928)	名将 (美版 910928)	Capcom
captcomj	名将 (日版 911202)	名将 (日版 911202)	Capcom
knights	圆桌骑士 (世界版 911127)	圆桌骑士 (世界版 911127)	Capcom
knightsu	圆桌骑士 (美版 911127)	圆桌骑士 (美版 911127)	Capcom
knightsj	圆桌骑士 (日版 911127)	圆桌骑士 (日版 911127)	Capcom
sf2ce	街头霸王 II' - 四大天王 (世界版 920313)	街头霸王 II' - 四大天王 (世界版 920313)	Capcom
sf2ceua	街头霸王 II' - 四大天王 (美版 920313)	街头霸王 II' - 四大天王 (美版 920313)	Capcom
sf2ceub	街头霸王 II' - 四大天王 (美版 920513)	街头霸王 II' - 四大天王 (美版 920513)	Capcom
sf2ceuc	街头霸王 II' - 四大天王 (美版 920803)	街头霸王 II' - 四大天王 (美版 920803)	Capcom
sf2cej	街头霸王 II' - 四大天王 (日版 920513)	街头霸王 II' - 四大天王 (日版 920513)	Capcom
sf2rb	街头霸王 II' - 四大天王 (彩虹版 set 1)	街头霸王 II' - 四大天王 (彩虹版 set 1)	hack / bootleg
sf2rb2	街头霸王 II' - 四大天王 (彩虹版 set 2)	街头霸王 II' - 四大天王 (彩虹版 set 2)	hack / bootleg
sf2red	街头霸王 II' - 四大天王 (赤色波动)	街头霸王 II' - 四大天王 (赤色波动)	hack / bootleg
sf2v004	街头霸王 II! - 四大天王 (V004)	街头霸王 II! - 四大天王 (V004)	hack / bootleg
sf2accp2	街头霸王 II' - 四大天王 (Accelerator Pt.II)	街头霸王 II' - 四大天王 (Accelerator Pt.II)	hack / bootleg
sf2m1	街头霸王 II - 四大天王 (M1)	街头霸王 II - 四大天王 (M1)	hack / bootleg
sf2m2	街头霸王 II - 四大天王 (M2)	街头霸王 II - 四大天王 (M2)	hack / bootleg
sf2m3	街头霸王 II - 四大天王 (M3)	街头霸王 II - 四大天王 (M3)	hack / bootleg
sf2m4	街头霸王 II - 四大天王 (M4)	街头霸王 II - 四大天王 (M4)	hack / bootleg
sf2m5	街头霸王 II - 四大天王 (M5)	街头霸王 II - 四大天王 (M5)	hack / bootleg
sf2m6	降龙 (set 2)	降龙 (set 2)	hack / bootleg
sf2m7	街头霸王 II - 四大天王 (M7)	街头霸王 II - 四大天王 (M7)	hack / bootleg
sf2yyc	街头霸王 II - 四大天王 (YYC)	街头霸王 II - 四大天王 (YYC)	hack / bootleg
sf2koryu	降龙 (set 1)	降龙 (set 1)	hack / bootleg
varth	威虎战机 - 雷暴行动 (世界版 920714)	威虎战机 - 雷暴行动 (世界版 920714)	Capcom
varthr1	威虎战机 - 雷暴行动 (世界版 920612)	威虎战机 - 雷暴行动 (世界版 920612)	Capcom
varthu	威虎战机 - 雷暴行动 (美版 920612)	威虎战机 - 雷暴行动 (美版 920612)	Capcom (Romstar license)
varthj	威虎战机 - 雷暴行动 (日版 920714)	威虎战机 - 雷暴行动 (日版 920714)	Capcom
cworld2j	冒险问答 - Capcom 世界 2 (日版 920611)	冒险问答 - Capcom 世界 2 (日版 920611)	Capcom
wof	吞食天地 II 赤壁之战 / Warriors of Fate (世界版 921002)	吞食天地 II 赤壁之战 / Warriors of Fate (世界版 921002)	Capcom
wofa	吞食天地 II 赤壁之战 / 三国志 II (亚洲版 921005)	吞食天地 II 赤壁之战 / 三国志 II (亚洲版 921005)	Capcom
wofu	吞食天地 II 赤壁之战 / Warriors of Fate (美版 921031)	吞食天地 II 赤壁之战 / Warriors of Fate (美版 921031)	Capcom
wofj	吞食天地 II 赤壁之战 (日版 921031)	吞食天地 II 赤壁之战 (日版 921031)	Capcom
sf2hf	街头霸王 II - Hyper Fighting (世界版 921209)	街头霸王 II - Hyper Fighting (世界版 921209)	Capcom
sf2t	街头霸王 II' Turbo - Hyper Fighting (美版 921209)	街头霸王 II' Turbo - Hyper Fighting (美版 921209)	Capcom
sf2tj	街头霸王 II' Turbo - Hyper Fighting (日版 921209)	街头霸王 II' Turbo - Hyper Fighting (日版 921209)	Capcom
dino	恐龙时代 / 凯迪拉克 - 恐龙新世纪 (世界版 930201)	恐龙时代 / 凯迪拉克 - 恐龙新世纪 (世界版 930201)	Capcom
dinou	恐龙时代 / 凯迪拉克 - 恐龙新世纪 (美版 930201)	恐龙时代 / 凯迪拉克 - 恐龙新世纪 (美版 930201)	Capcom
dinoj	恐龙时代 / 凯迪拉克 - 恐龙新世纪 (日版 930201)	恐龙时代 / 凯迪拉克 - 恐龙新世纪 (日版 930201)	Capcom
punisher	惩罚者 / 复仇者 (世界版 930422)	惩罚者 / 复仇者 (世界版 930422)	Capcom
punishru	惩罚者 / 复仇者 (美版 930422)	惩罚者 / 复仇者 (美版 930422)	Capcom
punishrj	惩罚者 / 复仇者 (日版 930422)	惩罚者 / 复仇者 (日版 930422)	Capcom
slammast	摔跤霸王 (世界版 930713)	摔跤霸王 (世界版 930713)	Capcom
slammasu	摔跤霸王 (美版 930713)	摔跤霸王 (美版 930713)	Capcom
mbomberj	摔跤霸王 - 肌肉爆弹 (日版 930713)	摔跤霸王 - 肌肉爆弹 (日版 930713)	Capcom
mbombrd	摔跤霸王 Duo - 最终之战 (世界版 931206)	摔跤霸王 Duo - 最终之战 (世界版 931206)	Capcom
mbombrdj	摔跤霸王 Duo - 热血战士 (日版 931206)	摔跤霸王 Duo - 热血战士 (日版 931206)	Capcom
pnickj	魔法方块 (日版 940608)	魔法方块 (日版 940608)	Compile (Capcom license)
qad	龙之迷题 (美版 920701)	龙之迷题 (美版 920701)	Capcom
qadj	龙之迷题 (日版 940921)	龙之迷题 (日版 940921)	Capcom
qtono2	问答 信长之野望 2 全国版 (日版 950123)	问答 信长之野望 2 全国版 (日版 950123)	Capcom
pang3	魔法气泡 3 - 怪盗们的华丽午后- (欧洲版 950511)	魔法气泡 3 - 怪盗们的华丽午后- (欧洲版 950511)	Mitchell
pang3j	魔法气泡 3 - 怪盗们的华丽午后- (日版 950511)	魔法气泡 3 - 怪盗们的华丽午后- (日版 950511)	Mitchell
megaman	洛克人 - 力量对决 (CPS1 亚洲版 951006)	洛克人 - 力量对决 (CPS1 亚洲版 951006)	Capcom
rockmanj	洛克人 - 力量对决 (CPS1 日版 950922)	洛克人 - 力量对决 (CPS1 日版 950922)	Capcom
fcrash	终结快打 (世界版, 盗版)	终结快打 (世界版, 盗版)	Playmark, bootleg [Capcom]
ssf2	超级街头霸王 II: 新挑战者 (世界版 930911)	超级街头霸王 II: 新挑战者 (世界版 930911)	Capcom
ssf2u	超级街头霸王 II: 新挑战者 (美版 930911)	超级街头霸王 II: 新挑战者 (美版 930911)	Capcom
ssf2a	超级街头霸王 II: 新挑战者 (亚洲版 931005)	超级街头霸王 II: 新挑战者 (亚洲版 931005)	Capcom
ssf2ar1	超级街头霸王 II: 新挑战者 (亚洲版 930914)	超级街头霸王 II: 新挑战者 (亚洲版 930914)	Capcom
ssf2j	超级街头霸王 II: 新挑战者 (日版 931005)	超级街头霸王 II: 新挑战者 (日版 931005)	Capcom
ssf2jr1	超级街头霸王 II: 新挑战者 (日版 930911)	超级街头霸王 II: 新挑战者 (日版 930911)	Capcom
ssf2jr2	超级街头霸王 II: 新挑战者 (日版 930910)	超级街头霸王 II: 新挑战者 (日版 930910)	Capcom
ssf2tb	超级街头霸王 II: 争斗之赛 (世界版 931119)	超级街头霸王 II: 争斗之赛 (世界版 931119)	Capcom
ssf2tbr1	超级街头霸王 II: 争斗之赛 (世界版 930911)	超级街头霸王 II: 争斗之赛 (世界版 930911)	Capcom
ssf2tbj	超级街头霸王 II: 争斗之赛 (日版 930911)	超级街头霸王 II: 争斗之赛 (日版 930911)	Capcom
ecofghtr	生态战士 (世界版 931203)	生态战士 (世界版 931203)	Capcom
ecofghtu	生态战士 (美版 931203)	生态战士 (美版 931203)	Capcom
ecofghta	生态战士 (亚洲版 931203)	生态战士 (亚洲版 931203)	Capcom
uecology	最终生态 (日版 931203)	最终生态 (日版 931203)	Capcom
ddtod	龙与地下城: 毁灭之塔 (欧洲版 940412)	龙与地下城: 毁灭之塔 (欧洲版 940412)	Capcom
ddtodr1	龙与地下城: 毁灭之塔 (欧洲版 940113)	龙与地下城: 毁灭之塔 (欧洲版 940113)	Capcom
ddtodu	龙与地下城: 毁灭之塔 (美版 940125)	龙与地下城: 毁灭之塔 (美版 940125)	Capcom
ddtodur1	龙与地下城: 毁灭之塔 (美版 940113)	龙与地下城: 毁灭之塔 (美版 940113)	Capcom
ddtodj	龙与地下城: 毁灭之塔 (日版 940125)	龙与地下城: 毁灭之塔 (日版 940125)	Capcom
ddtodjr1	龙与地下城: 毁灭之塔 (日版 940113)	龙与地下城: 毁灭之塔 (日版 940113)	Capcom
ddtoda	龙与地下城: 毁灭之塔 (亚洲版 940113)	龙与地下城: 毁灭之塔 (亚洲版 940113)	Capcom
ddtodh	龙与地下城: 毁灭之塔 (西班牙版 940125)	龙与地下城: 毁灭之塔 (西班牙版 940125)	Capcom
ssf2t	超级街头霸王 II Turbo (世界版 940223)	超级街头霸王 II Turbo (世界版 940223)	Capcom
ssf2tu	超级街头霸王 II Turbo (美版 940323)	超级街头霸王 II Turbo (美版 940323)	Capcom
ssf2tur1	超级街头霸王 II Turbo (美版 940223)	超级街头霸王 II Turbo (美版 940223)	Capcom
ssf2ta	超级街头霸王 II Turbo (亚洲版 940223)	超级街头霸王 II Turbo (亚洲版 940223)	Capcom
ssf2xj	超级街头霸王 II X: 大师级挑战者 (日版 940223)	超级街头霸王 II X: 大师级挑战者 (日版 940223)	Capcom
avsp	异形 对 铁血战士 (欧洲版 940520)	异形 对 铁血战士 (欧洲版 940520)	Capcom
avspu	异形 对 铁血战士 (美版 940520)	异形 对 铁血战士 (美版 940520)	Capcom
avspj	异形 对 铁血战士 (日版 940520)	异形 对 铁血战士 (日版 940520)	Capcom
avspa	异形 对 铁血战士 (亚洲版 940520)	异形 对 铁血战士 (亚洲版 940520)	Capcom
avsph	异形 对 铁血战士 (西班牙版 940520)	异形 对 铁血战士 (西班牙版 940520)	Capcom
dstlk	恶魔战士: 午夜斗士 (欧洲版 940705)	恶魔战士: 午夜斗士 (欧洲版 940705)	Capcom
dstlku	恶魔战士: 午夜斗士 (美版 940818)	恶魔战士: 午夜斗士 (美版 940818)	Capcom
dstlkur1	恶魔战士: 午夜斗士 (美版 940705)	恶魔战士: 午夜斗士 (美版 940705)	Capcom
dstlka	恶魔战士: 午夜斗士 (亚洲版 940705)	恶魔战士: 午夜斗士 (亚洲版 940705)	Capcom
vampj	吸血鬼: 午夜斗士 (日版 940705)	吸血鬼: 午夜斗士 (日版 940705)	Capcom
vampja	吸血鬼: 午夜斗士 (日版 940705 alt)	吸血鬼: 午夜斗士 (日版 940705 alt)	Capcom
vampjr1	吸血鬼: 午夜斗士 (日版 940630)	吸血鬼: 午夜斗士 (日版 940630)	Capcom
ringdest	摔角霸王 II (欧洲版 940902)	摔角霸王 II (欧洲版 940902)	Capcom
smbomb	超级摔角霸王: 连环爆裂 (日版 940831)	超级摔角霸王: 连环爆裂 (日版 940831)	Capcom
smbombr1	超级摔角霸王: 连环爆裂 (日版 940808)	超级摔角霸王: 连环爆裂 (日版 940808)	Capcom
armwar	机甲战士 (欧洲版 941024)	机甲战士 (欧洲版 941024)	Capcom
armwarr1	机甲战士 (欧洲版 941011)	机甲战士 (欧洲版 941011)	Capcom
armwaru	机甲战士 (美版 941024)	机甲战士 (美版 941024)	Capcom
pgear	机甲装备: 攻关版 (日版 941024)	机甲装备: 攻关版 (日版 941024)	Capcom
pgearr1	机甲装备: 攻关版 (日版 940916)	机甲装备: 攻关版 (日版 940916)	Capcom
armwara	机甲战士 (亚洲版 940920)	机甲战士 (亚洲版 940920)	Capcom
xmcota	X-战警: 磁场原子人 (欧洲版 950105)	X-战警: 磁场原子人 (欧洲版 950105)	Capcom
xmcotau	X-战警: 磁场原子人 (美版 950105)	X-战警: 磁场原子人 (美版 950105)	Capcom
xmcotah	X-战警: 磁场原子人 (西班牙版 950331)	X-战警: 磁场原子人 (西班牙版 950331)	Capcom
xmcotaj	X-战警: 磁场原子人 (日版 941219)	X-战警: 磁场原子人 (日版 941219)	Capcom
xmcotaj1	X-战警: 磁场原子人 (日版 941217)	X-战警: 磁场原子人 (日版 941217)	Capcom
xmcotaa	X-战警: 磁场原子人 (亚洲版 941217)	X-战警: 磁场原子人 (亚洲版 941217)	Capcom
xmcotajr	X-战警: 磁场原子人 (日版 941208 租借版)	X-战警: 磁场原子人 (日版 941208 租借版)	Capcom
nwarr	午夜战士: 恶魔的复仇 (美版 950406)	午夜战士: 恶魔的复仇 (美版 950406)	Capcom
nwarrh	午夜战士: 恶魔的复仇 (西班牙版 950403)	午夜战士: 恶魔的复仇 (西班牙版 950403)	Capcom
nwarrb	午夜战士: 恶魔的复仇 (巴西版 950403)	午夜战士: 恶魔的复仇 (巴西版 950403)	Capcom
nwarru	午夜战士: 恶魔的复仇 (美版 950406)	午夜战士: 恶魔的复仇 (美版 950406)	Capcom
vhuntj	吸血鬼猎人: 恶魔的复仇 (日版 950316)	吸血鬼猎人: 恶魔的复仇 (日版 950316)	Capcom
vhuntjr1	吸血鬼猎人: 恶魔的复仇 (日版 950307)	吸血鬼猎人: 恶魔的复仇 (日版 950307)	Capcom
vhuntjr2	吸血鬼猎人: 恶魔的复仇 (日版 950302)	吸血鬼猎人: 恶魔的复仇 (日版 950302)	Capcom
cybots	机甲战士: 全金属狂潮 (欧洲版 950424)	机甲战士: 全金属狂潮 (欧洲版 950424)	Capcom
cybotsu	机甲战士: 全金属狂潮 (美版 950424)	机甲战士: 全金属狂潮 (美版 950424)	Capcom
cybotsj	机甲战士: 全金属狂潮 (日版 950420)	机甲战士: 全金属狂潮 (日版 950420)	Capcom
sfa	少年街霸 阿尔法: 斗士之梦 (欧洲版 950727)	少年街霸 阿尔法: 斗士之梦 (欧洲版 950727)	Capcom
sfar1	少年街霸 阿尔法: 斗士之梦 (欧洲版 950718)	少年街霸 阿尔法: 斗士之梦 (欧洲版 950718)	Capcom
sfar2	少年街霸 阿尔法: 斗士之梦 (欧洲版 950627)	少年街霸 阿尔法: 斗士之梦 (欧洲版 950627)	Capcom
sfar3	少年街霸 阿尔法: 斗士之梦 (欧洲版 950605)	少年街霸 阿尔法: 斗士之梦 (欧洲版 950605)	Capcom
sfau	少年街霸 阿尔法: 斗士之梦 (美版 950627)	少年街霸 阿尔法: 斗士之梦 (美版 950627)	Capcom
sfza	少年街霸 零 (亚洲版 950627)	少年街霸 零 (亚洲版 950627)	Capcom
sfzj	少年街霸 零 (日版 950727)	少年街霸 零 (日版 950727)	Capcom
sfzjr1	少年街霸 零 (日版 950627)	少年街霸 零 (日版 950627)	Capcom
sfzjr2	少年街霸 零 (日版 950605)	少年街霸 零 (日版 950605)	Capcom
sfzh	少年街霸 零 (西班牙版 950627)	少年街霸 零 (西班牙版 950627)	Capcom
sfzb	少年街霸 零 (巴西版 951109)	少年街霸 零 (巴西版 951109)	Capcom
sfzbr1	少年街霸 零 (巴西版 950727)	少年街霸 零 (巴西版 950727)	Capcom
mmancp2u	洛克人 - 力量对决 (CPS2, 美版 951006)	洛克人 - 力量对决 (CPS2, 美版 951006)	Capcom
rmancp2j	洛克人 - 力量对决 (CPS2, 日版 950922)	洛克人 - 力量对决 (CPS2, 日版 950922)	Capcom
msh	超级漫画英雄 (欧洲版 951024)	超级漫画英雄 (欧洲版 951024)	Capcom
mshu	超级漫画英雄 (美版 951024)	超级漫画英雄 (美版 951024)	Capcom
mshj	超级漫画英雄 (日版 951117)	超级漫画英雄 (日版 951117)	Capcom
mshjr1	超级漫画英雄 (日版 951024)	超级漫画英雄 (日版 951024)	Capcom
msha	超级漫画英雄 (亚洲版 951024)	超级漫画英雄 (亚洲版 951024)	Capcom
mshh	超级漫画英雄 (西班牙版 951117)	超级漫画英雄 (西班牙版 951117)	Capcom
mshb	超级漫画英雄 (巴西版 951117)	超级漫画英雄 (巴西版 951117)	Capcom
19xx	19XX: 命运否决战 (美版 951207)	19XX: 命运否决战 (美版 951207)	Capcom
19xxj	19XX: 命运否决战 (日版 951225)	19XX: 命运否决战 (日版 951225)	Capcom
19xxjr1	19XX: 命运否决战 (日版 951207)	19XX: 命运否决战 (日版 951207)	Capcom
19xxa	19XX: 命运否决战 (亚洲版 951207)	19XX: 命运否决战 (亚洲版 951207)	Capcom
19xxh	19XX: 命运否决战 (西班牙版 951218)	19XX: 命运否决战 (西班牙版 951218)	Capcom
ddsom	龙与地下城 2: 暗黑秘影 (欧洲版 960619)	龙与地下城 2: 暗黑秘影 (欧洲版 960619)	Capcom
ddsomr1	龙与地下城 2: 暗黑秘影 (欧洲版 960223)	龙与地下城 2: 暗黑秘影 (欧洲版 960223)	Capcom
ddsomr2	龙与地下城 2: 暗黑秘影 (欧洲版 960209)	龙与地下城 2: 暗黑秘影 (欧洲版 960209)	Capcom
ddsomr3	龙与地下城 2: 暗黑秘影 (欧洲版 960208)	龙与地下城 2: 暗黑秘影 (欧洲版 960208)	Capcom
ddsomu	龙与地下城 2: 暗黑秘影 (美版 960619)	龙与地下城 2: 暗黑秘影 (美版 960619)	Capcom
ddsomur1	龙与地下城 2: 暗黑秘影 (美版 960209)	龙与地下城 2: 暗黑秘影 (美版 960209)	Capcom
ddsomjr1	龙与地下城 2: 暗黑秘影 (日版 960206)	龙与地下城 2: 暗黑秘影 (日版 960206)	Capcom
ddsomj	龙与地下城 2: 暗黑秘影 (日版 960619)	龙与地下城 2: 暗黑秘影 (日版 960619)	Capcom
ddsoma	龙与地下城 2: 暗黑秘影 (亚洲版 960619)	龙与地下城 2: 暗黑秘影 (亚洲版 960619)	Capcom
ddsomb	龙与地下城 2: 暗黑秘影 (巴西版 960223)	龙与地下城 2: 暗黑秘影 (巴西版 960223)	Capcom
sfa2	少年街霸 阿尔法 2 (美版 960306)	少年街霸 阿尔法 2 (美版 960306)	Capcom
sfz2j	少年街霸 零 2 (日版 960227)	少年街霸 零 2 (日版 960227)	Capcom
sfz2a	少年街霸 零 2 (亚洲版 960227)	少年街霸 零 2 (亚洲版 960227)	Capcom
sfz2b	少年街霸 零 2 (巴西版 960531)	少年街霸 零 2 (巴西版 960531)	Capcom
sfz2br1	少年街霸 零 2 (巴西版 960304)	少年街霸 零 2 (巴西版 960304)	Capcom
sfz2h	少年街霸 零 2 (西班牙版 960304)	少年街霸 零 2 (西班牙版 960304)	Capcom
sfz2n	少年街霸 零 2 (大洋洲版 960229)	少年街霸 零 2 (大洋洲版 960229)	Capcom
spf2t	超级方块战士 2 Turbo (美版 960620)	超级方块战士 2 Turbo (美版 960620)	Capcom
spf2xj	超级方块战士 2 X (日版 960531)	超级方块战士 2 X (日版 960531)	Capcom
spf2ta	超级方块战士 2 Turbo (亚洲版 960529)	超级方块战士 2 Turbo (亚洲版 960529)	Capcom
qndream	问答 七彩梦: 虹色町的奇迹 (日版 960826)	问答 七彩梦: 虹色町的奇迹 (日版 960826)	Capcom
megaman2	洛克人 2: 力量勇士 (美版 960708)	洛克人 2: 力量勇士 (美版 960708)	Capcom
megamn2a	洛克人 2: 力量勇士 (亚洲版 960708)	洛克人 2: 力量勇士 (亚洲版 960708)	Capcom
rckman2j	洛克人 2: 力量勇士 (日版 960708)	洛克人 2: 力量勇士 (日版 960708)	Capcom
sfz2aj	少年街霸 零 2 阿尔法 (日版 960805)	少年街霸 零 2 阿尔法 (日版 960805)	Capcom
sfz2ah	少年街霸 零 2 阿尔法 (西班牙版 960813)	少年街霸 零 2 阿尔法 (西班牙版 960813)	Capcom
sfz2ab	少年街霸 零 2 阿尔法 (巴西版 960813)	少年街霸 零 2 阿尔法 (巴西版 960813)	Capcom
sfz2aa	少年街霸 零 2 阿尔法 (亚洲版 960826)	少年街霸 零 2 阿尔法 (亚洲版 960826)	Capcom
xmvsf	X-战警 对 街霸 (欧洲版 961004)	X-战警 对 街霸 (欧洲版 961004)	Capcom
xmvsfr1	X-战警 对 街霸 (欧洲版 960910)	X-战警 对 街霸 (欧洲版 960910)	Capcom
xmvsfu	X-战警 对 街霸 (美版 961023)	X-战警 对 街霸 (美版 961023)	Capcom
xmvsfur1	X-战警 对 街霸 (美版 961004)	X-战警 对 街霸 (美版 961004)	Capcom
xmvsfj	X-战警 对 街霸 (日版 961004)	X-战警 对 街霸 (日版 961004)	Capcom
xmvsfjr1	X-战警 对 街霸 (日版 960910)	X-战警 对 街霸 (日版 960910)	Capcom
xmvsfjr2	X-战警 对 街霸 (日版 960909)	X-战警 对 街霸 (日版 960909)	Capcom
xmvsfa	X-战警 对 街霸 (亚洲版 961023)	X-战警 对 街霸 (亚洲版 961023)	Capcom
xmvsfar1	X-战警 对 街霸 (亚洲版 960919)	X-战警 对 街霸 (亚洲版 960919)	Capcom
xmvsfh	X-战警 对 街霸 (西班牙版 961004)	X-战警 对 街霸 (西班牙版 961004)	Capcom
xmvsfb	X-战警 对 街霸 (巴西版 961023)	X-战警 对 街霸 (巴西版 961023)	Capcom
batcir	战斗回路 (欧洲版 970319)	战斗回路 (欧洲版 970319)	Capcom
batcirj	战斗回路 (日版 970319)	战斗回路 (日版 970319)	Capcom
batcira	战斗回路 (亚洲版 970319)	战斗回路 (亚洲版 970319)	Capcom
vsav	吸血鬼救世主: 恶魔的上帝 (欧洲版 970519)	吸血鬼救世主: 恶魔的上帝 (欧洲版 970519)	Capcom
vsavu	吸血鬼救世主: 恶魔的上帝 (美版 970519)	吸血鬼救世主: 恶魔的上帝 (美版 970519)	Capcom
vsavj	吸血鬼救世主: 恶魔的上帝 (日版 970519)	吸血鬼救世主: 恶魔的上帝 (日版 970519)	Capcom
vsava	吸血鬼救世主: 恶魔的上帝 (亚洲版 970519)	吸血鬼救世主: 恶魔的上帝 (亚洲版 970519)	Capcom
vsavh	吸血鬼救世主: 恶魔的上帝 (西班牙版 970519)	吸血鬼救世主: 恶魔的上帝 (西班牙版 970519)	Capcom
mshvsf	超级漫画英雄 对 街霸 (欧洲版 970625)	超级漫画英雄 对 街霸 (欧洲版 970625)	Capcom
mshvsfu	超级漫画英雄 对 街霸 (美版 970827)	超级漫画英雄 对 街霸 (美版 970827)	Capcom
mshvsfu1	超级漫画英雄 对 街霸 (美版 970625)	超级漫画英雄 对 街霸 (美版 970625)	Capcom
mshvsfj	超级漫画英雄 对 街霸 (日版 970707)	超级漫画英雄 对 街霸 (日版 970707)	Capcom
mshvsfj1	超级漫画英雄 对 街霸 (日版 970702)	超级漫画英雄 对 街霸 (日版 970702)	Capcom
mshvsfj2	超级漫画英雄 对 街霸 (日版 970625)	超级漫画英雄 对 街霸 (日版 970625)	Capcom
mshvsfh	超级漫画英雄 对 街霸 (西班牙版 970625)	超级漫画英雄 对 街霸 (西班牙版 970625)	Capcom
mshvsfa	超级漫画英雄 对 街霸 (亚洲版 970625)	超级漫画英雄 对 街霸 (亚洲版 970625)	Capcom
mshvsfa1	超级漫画英雄 对 街霸 (亚洲版 970620)	超级漫画英雄 对 街霸 (亚洲版 970620)	Capcom
mshvsfb	超级漫画英雄 对 街霸 (巴西版 970827)	超级漫画英雄 对 街霸 (巴西版 970827)	Capcom
mshvsfb1	超级漫画英雄 对 街霸 (巴西版 970625)	超级漫画英雄 对 街霸 (巴西版 970625)	Capcom
csclub	Capcom 运动俱乐部 (欧洲版 970722)	Capcom 运动俱乐部 (欧洲版 970722)	Capcom
csclubj	Capcom 运动俱乐部 (日版 970722)	Capcom 运动俱乐部 (日版 970722)	Capcom
cscluba	Capcom 运动俱乐部 (亚洲版 970722)	Capcom 运动俱乐部 (亚洲版 970722)	Capcom
csclubh	Capcom 运动俱乐部 (西班牙版 970722)	Capcom 运动俱乐部 (西班牙版 970722)	Capcom
sgemf	超级宝石之战 - 迷你之战 (美版 970904)	超级宝石之战 - 迷你之战 (美版 970904)	Capcom
pfghtj	口袋战士 (日版 970904)	口袋战士 (日版 970904)	Capcom
sgemfa	超级宝石之战 - 迷你之战 (亚洲版 970904)	超级宝石之战 - 迷你之战 (亚洲版 970904)	Capcom
sgemfh	超级宝石之战 - 迷你之战 (西班牙版 970904)	超级宝石之战 - 迷你之战 (西班牙版 970904)	Capcom
vhunt2r1	吸血鬼猎人 2: 恶魔的复仇 (日版 970913)	吸血鬼猎人 2: 恶魔的复仇 (日版 970913)	Capcom
vhunt2	吸血鬼猎人 2: 恶魔的复仇 (日版 970929)	吸血鬼猎人 2: 恶魔的复仇 (日版 970929)	Capcom
vsav2	吸血鬼救世主 2: 恶魔的上帝 (日版 970913)	吸血鬼救世主 2: 恶魔的上帝 (日版 970913)	Capcom
mvsc	漫画英雄 对 Capcom: 超级英雄的冲突 (欧洲版 980112)	漫画英雄 对 Capcom: 超级英雄的冲突 (欧洲版 980112)	Capcom
mvscu	漫画英雄 对 Capcom: 超级英雄的冲突 (美版 980123)	漫画英雄 对 Capcom: 超级英雄的冲突 (美版 980123)	Capcom
mvscj	漫画英雄 对 Capcom: 超级英雄的冲突 (日版 980123)	漫画英雄 对 Capcom: 超级英雄的冲突 (日版 980123)	Capcom
mvscjr1	漫画英雄 对 Capcom: 超级英雄的冲突 (日版 980112)	漫画英雄 对 Capcom: 超级英雄的冲突 (日版 980112)	Capcom
mvsca	漫画英雄 对 Capcom: 超级英雄的冲突 (亚洲版 980123)	漫画英雄 对 Capcom: 超级英雄的冲突 (亚洲版 980123)	Capcom
mvscar1	漫画英雄 对 Capcom: 超级英雄的冲突 (亚洲版 980112)	漫画英雄 对 Capcom: 超级英雄的冲突 (亚洲版 980112)	Capcom
mvsch	漫画英雄 对 Capcom: 超级英雄的冲突 (西班牙版 980123)	漫画英雄 对 Capcom: 超级英雄的冲突 (西班牙版 980123)	Capcom
mvscb	漫画英雄 对 Capcom: 超级英雄的冲突 (巴西版 980123)	漫画英雄 对 Capcom: 超级英雄的冲突 (巴西版 980123)	Capcom
sfa3	少年街霸 阿尔法 3 (美版 980904)	少年街霸 阿尔法 3 (美版 980904)	Capcom
sfa3r1	少年街霸 阿尔法 3 (美版 980629)	少年街霸 阿尔法 3 (美版 980629)	Capcom
sfa3b	少年街霸 阿尔法 3 (巴西版 980629)	少年街霸 阿尔法 3 (巴西版 980629)	Capcom
sfz3j	少年街霸 零 3 (日版 980904)	少年街霸 零 3 (日版 980904)	Capcom
sfz3jr1	少年街霸 零 3 (日版 980727)	少年街霸 零 3 (日版 980727)	Capcom
sfz3jr2	少年街霸 零 3 (日版 980629)	少年街霸 零 3 (日版 980629)	Capcom
sfz3a	少年街霸 3 零 (亚洲版 980904)	少年街霸 零 3 (亚洲版 980904)	Capcom
sfz3ar1	少年街霸 零 3 (亚洲版 980701)	少年街霸 零 3 (亚洲版 980701)	Capcom
gigawing	千兆翼 (美版 990222)	千兆翼 (美版 990222)	Capcom, supported by Takumi
gwingj	千兆翼 (日版 990223)	千兆翼 (日版 990223)	Capcom, supported by Takumi
gwinga	千兆翼 (亚洲版 990222)	千兆翼 (亚洲版 990222)	Capcom, supported by Takumi
jyangoku	雀国志: 霸王之采牌 (日版 990527)	雀国志: 霸王之采牌 (日版 990527)	Capcom
dimahoo	大魔法 (美版 000121)	大魔法 (美版 000121)	Eighting/Raizing, distributed by Capcom
gmahou	伟大的魔法大作战 (日版 000121)	伟大的魔法大作战 (日版 000121)	Eighting/Raizing, distributed by Capcom
mmatrix	火烈巨阵: 超固体射击 (美版 000412)	火烈巨阵: 超固体射击 (美版 000412)	Capcom, supported by Takumi
mmatrixj	火烈巨阵: 超固体射击 (日版 000412)	火烈巨阵: 超固体射击 (日版 000412)	Capcom, supported by Takumi
1944	1944: 环岛之战 (美版 000620)	1944: 环岛之战 (美版 000620)	Capcom, supported by Eighting/Raizing
1944j	1944: 环岛之战 (日版 000620)	1944: 环岛之战 (日版 000620)	Capcom, supported by Eighting/Raizing
mpang	Mighty! Pang (美版 001010)	Mighty! Pang (美版 001010)	Mitchell, distributed by Capcom
mpangj	Mighty! Pang (日版 001011)	Mighty! Pang (日版 001011)	Mitchell, distributed by Capcom
progear	疾风之岚 (美版 010117)	疾风之岚 (美版 010117)	Capcom, supported by Cave
progearj	疾风之岚 (日版 010117)	疾风之岚 (日版 010117)	Capcom, supported by Cave
progeara	疾风之岚 (亚洲版 010117)	疾风之岚 (亚洲版 010117)	Capcom, supported by Cave
pzloop2	环绕球 2 (欧版 010302)	环绕球 2 (欧版 010302)	Mitchell, distributed by Capcom
pzloop2j	环绕球 2 (日版 010205)	环绕球 2 (日版 010205)	Mitchell, distributed by Capcom
choko	长江 (日版 010820)	长江 (日版 010820)	Mitchell, distributed by Capcom
hsf2j	超级街霸 2：周年纪念版 (日版 031222)	超级街霸 2：周年纪念版 (日版 031222)	Capcom
hsf2	超级街霸 2：周年纪念版 (亚洲版 040202)	超级街霸 2：周年纪念版 (亚洲版 040202)	Capcom
warzard	Warzard / 红色地球 (日版 96/11/21)	Warzard / 红色地球 (日版 96/11/21)	Capcom
sfiii	街头霸王 3 - 新的时代 (日版 970204)	街头霸王 3 - 新的时代 (日版 970204)	Capcom
jojo	JoJo 的奇妙冒险 (日版 981202)	JoJo 的奇妙冒险 (日版 981202)	Capcom
jojoalt	JoJo 的奇妙冒险 (日版 990108)	JoJo 的奇妙冒险 (日版 990108)	Capcom
jojoba	JoJo 的奇妙冒险 给未来的遗产	JoJo 的奇妙冒险 给未来的遗产	Capcom
jojobaa	JoJo 的奇妙冒险 给未来的遗产 (alt)	JoJo 的奇妙冒险 给未来的遗产 (alt)	Capcom
sfiii2	街头霸王 3 - 第二冲击: 强大的攻击 (日版 970930)	街头霸王 3 - 第二冲击: 强大的攻击 (日版 970930)	Capcom
sfiii3	街头霸王 3 - 第三战斗: 最后对抗 (美版 990512)	街头霸王 3 - 第三战斗: 最后对抗 (美版 990512)	Capcom
sfiii3a	街头霸王 3 - 第三战斗: 最后对抗 (美版 990608)	街头霸王 3 - 第三战斗: 最后对抗 (美版 990608)	Capcom
ts2	斗神传 2 (美版 951124)	斗神传 2 (美版 951124)	Capcom/Takara
ts2j	斗神传 2 (日版 951124)	斗神传 2 (日版 951124)	Capcom/Takara
starglad	星际斗士 (美版 960627)	星际斗士 (美版 960627)	Capcom
sfex	街头霸王 EX (美版 961219)	街头霸王 EX (美版 961219)	Capcom/Arika
sfexa	街头霸王 EX (亚洲版 961219)	街头霸王 EX (亚洲版 961219)	Capcom/Arika
sfexj	街头霸王 EX (日版 961130)	街头霸王 EX (日版 961130)	Capcom/Arika
sfexu	街头霸王 EX (美版 961219)	街头霸王 EX (美版 961219)	Capcom/Arika
sfexp	街头霸王 EX Plus (美版 970407)	街头霸王 EX Plus (美版 970407)	Capcom/Arika
sfexpu1	街头霸王 EX Plus (美版 970311)	街头霸王 EX Plus (美版 970311)	Capcom/Arika
sfexpj	街头霸王 EX Plus (日版 970311)	街头霸王 EX Plus (日版 970311)	Capcom/Arika
rvschool	私立公平学园 (美版 971117)	私立公平学园 (美版 971117)	Capcom
rvschola	私立公平学园 (亚洲版 971117)	私立公平学园 (亚洲版 971117)	Capcom
jgakuen	私立公平学园 (日版 971117)	私立公平学园 (日版 971117)	Capcom
sfex2	街头霸王 EX 2 (美版 980526)	街头霸王 EX 2 (美版 980526)	Capcom/Arika
sfex2j	街头霸王 EX 2 (日版 980312)	街头霸王 EX 2 (日版 980312)	Capcom/Arika
sfex2a	街头霸王 EX 2 (亚洲版 980312)	街头霸王 EX 2 (亚洲版 980312)	Capcom/Arika
stargld2	星际斗士 2 (日版 980316)	星际斗士 2 (日版 980316)	Capcom
tgmj	方块的特级大师 (日版 980710)	方块的特级大师 (日版 980710)	Capcom/Arika
techromn	Tech Romancer (欧版 980914)	Tech Romancer (欧版 980914)	Capcom
techromu	Tech Romancer (美版 980914)	Tech Romancer (美版 980914)	Capcom
sfex2p	街头霸王 EX 2 Plus (美版 990611)	街头霸王 EX 2 Plus (美版 990611)	Capcom/Arika
sfex2pa	街头霸王 EX 2 Plus (亚洲版 990611)	街头霸王 EX 2 Plus (亚洲版 990611)	Capcom/Arika
sfex2pj	街头霸王 EX 2 Plus (日版 990611)	街头霸王 EX 2 Plus (日版 990611)	Capcom/Arika
strider2	出击飞龙 2 (美版 991213)	出击飞龙 2 (美版 991213)	Capcom
stridr2a	出击飞龙 2 (亚洲版 991213)	出击飞龙 2 (亚洲版 991213)	Capcom
shiryu2	出击飞龙 2 (日版 991213)	出击飞龙 2 (日版 991213)	Capcom
doapp	生与死++ (日版)	生与死++ (日版)	Tecmo
jdredd	特警判官 (Rev C Dec. 17 1997)	特警判官 (Rev C Dec. 17 1997)	Acclaim
jdreddb	特警判官 (Rev B Nov. 26 1997)	特警判官 (Rev B Nov. 26 1997)	Acclaim
psyforce	精神力量 (Ver 2.4O)	精神力量 (Ver 2.4O)	Taito
psyforcj	精神力量 (Ver 2.4J)	精神力量 (Ver 2.4J)	Taito
psyfrcex	精神力量 EX (Ver 2.0J)	精神力量 EX (Ver 2.0J)	Taito
mgcldate	魔幻之日 / 魔幻之日 - dokidoki kokuhaku daisakusen (Ver 2.02J)	魔幻之日 / 魔幻之日 - dokidoki kokuhaku daisakusen (Ver 2.02J)	Taito
mgcldtex	魔幻之日 EX / 魔幻之日 - sotsugyou kokuhaku daisakusen (Ver 2.01J)	魔幻之日 EX / 魔幻之日 - sotsugyou kokuhaku daisakusen (Ver 2.01J)	Taito
tekken	铁拳 (TE4/VER.C)	铁拳 (TE4/VER.C)	Namco
tekkena	铁拳 (TE2/VER.C)	铁拳 (TE2/VER.C)	Namco
tekkenb	铁拳 (TE2/VER.B)	铁拳 (TE2/VER.B)	Namco
tekkenc	铁拳 (TE1/VER.B)	铁拳 (TE1/VER.B)	Namco
tekken2	铁拳 2 Ver.B (TES3/VER.B)	铁拳 2 Ver.B (TES3/VER.B)	Namco
tekken2a	铁拳 2 Ver.B (TES2/VER.B)	铁拳 2 Ver.B (TES2/VER.B)	Namco
tekken2b	铁拳 2 (TES2/VER.A)	铁拳 2 (TES2/VER.A)	Namco
souledge	魂之利刃 Ver. II (SO4/VER.C)	魂之利刃 Ver. II (SO4/VER.C)	Namco
souledga	魂之利刃 Ver. II (SO3/VER.C)	魂之利刃 Ver. II (SO3/VER.C)	Namco
souledgb	魂之利刃 (SO3/VER.A)	魂之利刃 (SO3/VER.A)	Namco
souledgc	魂之利刃 (SO1/VER.A)	魂之利刃 (SO1/VER.A)	Namco
xevi3dg	铁板阵 3D/G (XV31/VER.A)	铁板阵 3D/G (XV31/VER.A)	Namco
tekken3	铁拳 3 (TET1/VER.E1)	铁拳 3 (TET1/VER.E1)	Namco
tekken3a	铁拳 3 (TET2/VER.B)	铁拳 3 (TET2/VER.B)	Namco
tekken3b	铁拳 3 (TET2/VER.A)	铁拳 3 (TET2/VER.A)	Namco
soulclbr	灵魂能力 (SOC14/VER.C)	灵魂能力 (SOC14/VER.C)	Namco
soulclba	灵魂能力 (SOC11/VER.C)	灵魂能力 (SOC11/VER.C)	Namco
soulclbb	灵魂能力 (SOC11/VER.B)	灵魂能力 (SOC11/VER.B)	Namco
soulclbc	灵魂能力 (SOC11/VER.A2)	灵魂能力 (SOC11/VER.A2)	Namco
sws99	超级世界棒球 '99 (SS91/VER.A3)	超级世界棒球 '99 (SS91/VER.A3)	Namco
tektagt	铁拳沙漠赛 (TEG3/VER.C1)	铁拳沙漠赛 (TEG3/VER.C1)	Namco
tektagta	铁拳沙漠赛 (TEG3/VER.B)	铁拳沙漠赛 (TEG3/VER.B)	Namco
tektagtb	铁拳沙漠赛 (TEG1/VER.B)	铁拳沙漠赛 (TEG1/VER.B)	Namco
tektagtc	铁拳沙漠赛 (TEG1/VER.A3)	铁拳沙漠赛 (TEG1/VER.A3)	Namco
mrdrillr	钻地先生 (DRI1/VER.A2)	钻地先生 (DRI1/VER.A2)	Namco
mrdrilr2	钻地先生 2 (DR21 Ver.A)	钻地先生 2 (DR21 Ver.A)	Namco
mrdrilrg	钻地先生 G (DRG1 Ver.A)	钻地先生 G (DRG1 Ver.A)	Namco
kdeadeye	死亡之眼 (GV054 UA01)	死亡之眼 (GV054 UA01)	Konami
mgakuen	麻雀学园 - 卒业编	麻雀学园 - 卒业编	Yuga
7toitsu	麻雀学园 / 七对子	麻雀学园 / 七对子	Yuga
mgakuen2	麻雀学园 2 - 学园长的复仇	麻雀学园 2 - 学园长的复仇	Face
pkladies	同花顺	同花顺	Mitchell
pkladiel	同花顺 (Leprechaun ver. 510)	同花顺 (Leprechaun ver. 510)	Leprechaun
pkladila	同花顺 (Leprechaun ver. 401)	同花顺 (Leprechaun ver. 401)	Leprechaun
pang	魔法气泡 / Pang (世界版)	魔法气泡 / Pang (世界版)	Mitchell
pangb	魔法气泡 / Pang (盗版)	魔法气泡 / Pang (盗版)	bootleg
bbros	魔法气泡 / Buster Bros (美版)	魔法气泡 / Buster Bros (美版)	Capcom
pompingw	魔法气泡 (日版)	魔法气泡 (日版)	Mitchell
cbasebal	Capcom 棒球 (日版)	Capcom 棒球 (日版)	Capcom
cworld	冒险问答 - Capcom 世界 (日版)	冒险问答 - Capcom 世界 (日版)	Capcom
hatena	冒险问答 2 Hatena 大冒险 (日版 900228)	冒险问答 2 Hatena 大冒险 (日版 900228)	Capcom
spang	超级魔法气泡 (世界版 900914)	超级魔法气泡 (世界版 900914)	Mitchell
spangj	超级魔法气泡 (日版 901023)	超级魔法气泡 (日版 901023)	Mitchell
sbbros	超级魔法气泡 (美版 901001)	超级魔法气泡 (美版 901001)	Mitchell + Capcom
marukin	超级麻将(日版 901017)	超级麻将(日版 901017)	Yuga
qtono1	问答 信长之野望 (日版)	问答 信长之野望 (日版)	Capcom
qsangoku	问答 三国志 - 智略的霸者 (日版)	问答 三国志 - 智略的霸者 (日版)	Capcom
block	打砖块 (世界版 910910)	打砖块 (世界版 910910)	Capcom
blockj	打砖块 (日版 910910)	打砖块 (日版 910910)	Capcom
blockjoy	打砖块 (世界版 911106 Joystick)	打砖块 (世界版 911106 Joystick)	Capcom
blockbl	打砖块 (盗版)	打砖块 (盗版)	bootleg
capbowl	Capcom 保龄球 (set 1)	Capcom 保龄球 (set 1)	Incredible Technologies
capbowl2	Capcom 保龄球 (set 2)	Capcom 保龄球 (set 2)	Incredible Technologies
capbowl3	Capcom 保龄球 (set 3)	Capcom 保龄球 (set 3)	Incredible Technologies
capbowl4	Capcom 保龄球 (set 4)	Capcom 保龄球 (set 4)	Incredible Technologies
clbowl	Coors 光的保龄球	Coors 光的保龄球	Incredible Technologies
pairs	美女扑克 (V1.2, 09/30/94)	美女扑克 (V1.2, 09/30/94)	Strata/Incredible Technologies
pairsa	美女扑克 (09/07/94)	美女扑克 (09/07/94)	Strata/Incredible Technologies
hotmemry	美女扑克 (V1.2, 德国版)	美女扑克 (V1.2, 德国版)	Tuning/Incredible Technologies
sftm	街头霸王 电影版 (v1.12)	街头霸王 电影版 (v1.12)	Capcom/Incredible Technologies
sftm110	街头霸王 电影版 (v1.10)	街头霸王 电影版 (v1.10)	Capcom/Incredible Technologies
sftm111	街头霸王 电影版 (v1.11)	街头霸王 电影版 (v1.11)	Capcom/Incredible Technologies
sftmj	街头霸王 电影版 (v1.12N, 日版)	街头霸王 电影版 (v1.12N, 日版)	Capcom/Incredible Technologies
wseries	世界职业棒球大赛	世界职业棒球大赛	Cinematronics
dangerz	危险地带	危险地带	Cinematronics
basebal2	棒球季节 II	棒球季节 II	Cinematronics
aafb	全美职业橄榄球 (rev E)	全美职业橄榄球 (rev E)	Leland Corp.
aafbd2p	全美职业橄榄球 (rev D, 2位玩家版)	全美职业橄榄球 (rev D, 2位玩家版)	Leland Corp.
aafbc	全美职业橄榄球 (rev C)	全美职业橄榄球 (rev C)	Leland Corp.
aafbb	全美职业橄榄球 (rev B)	全美职业橄榄球 (rev B)	Leland Corp.
wsf	世界足球最终战	世界足球最终战	Leland Corp.
brutforc	极之暴力	极之暴力	Leland Corp.
mineswpr	扫雷艇	扫雷艇	Amutech
samurai	武士	武士	Sega
heiankyo	平安京异形	平安京异形	Denki Onkyo
pignewt	牛顿猪 (version C)	牛顿猪 (version C)	Sega
pignewta	牛顿猪 (version A)	牛顿猪 (version A)	Sega
mrviking	失落的维京人	失落的维京人	Sega
mrvikngj	失落的维京人 (日版)	失落的维京人 (日版)	Sega
bullfgt	斗牛 / Bullfight	斗牛 / Bullfight	Coreland / Sega
thetogyu	斗牛 (日版)	斗牛 (日版)	Coreland / Sega
spatter	三轮车 / Spatter	三轮车 / Spatter	Sega
ssanchan	三轮车 (日版)	三轮车 (日版)	Sega
seganinj	忍者王子 / 世嘉忍者	忍者王子 / 世嘉忍者	Sega
seganinu	忍者王子 / 世嘉忍者 (未加密)	忍者王子 / 世嘉忍者 (未加密)	Sega
ninja	忍者	忍者	Sega
nprinces	忍者王子 (64k Ver. 盗版?)	忍者王子 (64k Ver. 盗版?)	bootleg?
nprincso	忍者王子 (128k Ver.)	忍者王子 (128k Ver.)	Sega
nprincsu	忍者王子 (64k Ver. 未加密)	忍者王子 (64k Ver. 未加密)	Sega
nprincsb	忍者王子 (128k Ver. 盗版?)	忍者王子 (128k Ver. 盗版?)	bootleg?
myhero	青春 Scandal / My Hero (美版)	青春 Scandal / My Hero (美版)	Sega
sscandal	青春 Scandal (日版)	青春 Scandal (日版)	Coreland / Sega
myherok	青春 Scandal / My Hero (韩国版)	青春 Scandal / My Hero (韩国版)	Coreland / Sega
4dwarrio	4D 战士	4D 战士	Coreland / Sega
wboy	神奇男孩 (set 1, new encryption)	神奇男孩 (set 1, new encryption)	Sega (Escape license)
wboyo	神奇男孩 (set 1, old encryption)	神奇男孩 (set 1, old encryption)	Sega (Escape license)
wboy2	神奇男孩 (set 2)	神奇男孩 (set 2)	Sega (Escape license)
wboy2u	神奇男孩 (set 2 未加密)	神奇男孩 (set 2 未加密)	Sega (Escape license)
wboy3	神奇男孩 (set 3)	神奇男孩 (set 3)	Sega (Escape license)
wboy4	神奇男孩 (set 4)	神奇男孩 (set 4)	Sega (Escape license)
wboyu	神奇男孩 (未加密)	神奇男孩 (未加密)	Sega (Escape license)
wbdeluxe	神奇男孩 豪华版	神奇男孩 豪华版	Sega (Escape license)
wboysys2	神奇男孩 (system 2)	神奇男孩 (system 2)	Sega (Escape license)
tokisens	时间战士	时间战士	Sega
wbml	神奇男孩 - Monster Land (日版 新版.)	神奇男孩 - Monster Land (日版 新版.)	Sega / Westone
wbmljo	神奇男孩 - Monster Land (日版 旧版.)	神奇男孩 - Monster Land (日版 旧版.)	Sega / Westone
wbmljb	神奇男孩 - Monster Land (日版 未加密)	神奇男孩 - Monster Land (日版 未加密)	bootleg
wbmlb	神奇男孩 - Monster Land	神奇男孩 - Monster Land	bootleg
wbmlbg	神奇男孩 - Monster Land (Galaxy Electronics English bootleg)	神奇男孩 - Monster Land (Galaxy Electronics English bootleg)	bootleg
transfrm	变形金刚	变形金刚	Sega
astrofl	变形金刚 (日版)	变形金刚 (日版)	Sega
ridleofp	Pythagoras 之谜 (日版)	Pythagoras 之谜 (日版)	Sega / Nasco
fantzn2	神奇地带 2	神奇地带 2	Sega
opaopa	Opa Opa	Opa Opa	Sega
tetrisse	俄罗斯方块 (日版, System E)	俄罗斯方块 (日版, System E)	Sega
angelkds	小天使 (日版)	小天使 (日版)	Sega / Nasco?
aliensy1	异形特攻队 (set 1, System 16A, FD1089A 317-0033)	异形特攻队 (set 1, System 16A, FD1089A 317-0033)	Sega
aliensy2	异形特攻队 (set 2, System 16A, FD1089A 317-0033)	异形特攻队 (set 2, System 16A, FD1089A 317-0033)	Sega
bodyslam	Dump 松本 / Body Slam	Dump 松本 / Body Slam	Sega
dumpmtmt	Dump 松本 (日版)	Dump 松本 (日版)	Sega
mjleague	棒球联盟	棒球联盟	Sega
fantzone	神奇地带 (set 2, unprotected)	神奇地带 (set 2, unprotected)	Sega
sdi	SDI - 战略防卫构想	SDI - 战略防卫构想	Sega
shinobi	忍 (set 1)	忍 (set 1)	Sega
tetris	俄罗斯方块 (Sega set 1)	俄罗斯方块 (Sega set 1)	Sega
tetris3	俄罗斯方块 (set 3, Japan, System 16A, FD1094 317-0093a)	俄罗斯方块 (set 3, Japan, System 16A, FD1094 317-0093a)	Sega
wb31	神奇男孩 III - Monster Lair (set 1, System 16A, FD1094 317-0084)	神奇男孩 III - Monster Lair (set 1, System 16A, FD1094 317-0084)	Sega / Westone
aliensyn	异形特攻队 (set 1)	异形特攻队 (set 1)	Sega
aliensy3	异形特攻队 (set 3, System 16B, FD1089A 317-0033)	异形特攻队 (set 3, System 16B, FD1089A 317-0033)	Sega
altbeast	兽王记 (Version 1)	兽王记 (Version 1)	Sega
altbeasj	兽王记 (set 6, Japan, 8751 317-0077)	兽王记 (set 6, Japan, 8751 317-0077)	Sega
altbeas5	兽王记 (set 5, 8751 317-0076)	兽王记 (set 5, 8751 317-0076)	Sega
altbeas4	兽王记 (set 4, MC-8123B 317-0066)	兽王记 (set 4, MC-8123B 317-0066)	Sega
altbeaj3	兽王记 (set 3, Japan, FD1094 317-0068)	兽王记 (set 3, Japan, FD1094 317-0068)	Sega
altbeas2	兽王记 (Version 2)	兽王记 (Version 2)	Sega
altbeaj1	兽王记 (set 1, Japan, FD1094 317-0065)	兽王记 (set 1, Japan, FD1094 317-0065)	Sega
ddux	怪鸭冒险记 (set 2, FD1094 317-0096)	怪鸭冒险记 (set 2, FD1094 317-0096)	Sega
ddux1	怪鸭冒险记 (set 1, 8751 317-0095)	怪鸭冒险记 (set 1, 8751 317-0095)	Sega
goldnaxe	战斧 (set 6, 美版, 8751 317-123A)	战斧 (set 6, 美版, 8751 317-123A)	Sega
goldnaxu	战斧 (set 5, 美版, FD1094 317-0122)	战斧 (set 5, 美版, FD1094 317-0122)	Sega
goldnaxj	战斧 (set 4, 日版, FD1094 317-0121)	战斧 (set 4, 日版, FD1094 317-0121)	Sega
goldnax3	战斧 (set 3, 世界版, FD1094 317-0120)	战斧 (set 3, 世界版, FD1094 317-0120)	Sega
goldnax2	战斧 (set 2, 美版, 8751 317-0112)	战斧 (set 2, 美版, 8751 317-0112)	Sega
goldnax1	战斧 (set 1, 世界版, FD1094 317-0110)	战斧 (set 1, 世界版, FD1094 317-0110)	Sega
hwchamp	重量拳击	重量拳击	Sega
riotcity	暴乱之城	暴乱之城	Sega / Westone
tetris2	俄罗斯方块 (set 2, Japan, System 16B, FD1094 317-0092)	俄罗斯方块 (set 2, Japan, System 16B, FD1094 317-0092)	Sega
tetris1	俄罗斯方块 (set 1, Japan, System 16B, FD1094 317-0091)	俄罗斯方块 (set 1, Japan, System 16B, FD1094 317-0091)	Sega
toryumon	登龙门	登龙门	Sega
wb3	神奇男孩 III - 魔窟 (set 5, 世界版, System 16B, 8751 317-0098)	神奇男孩 III - 魔窟 (set 5, 世界版, System 16B, 8751 317-0098)	Sega / Westone
wb34	神奇男孩 III - Monster Lair (set 4, Japan, System 16B, FD1094 317-0087)	神奇男孩 III - Monster Lair (set 4, Japan, System 16B, FD1094 317-0087)	Sega / Westone
wb33	神奇男孩 III - Monster Lair (set 3, World, System 16B, FD1094 317-0089)	神奇男孩 III - Monster Lair (set 3, World, System 16B, FD1094 317-0089)	Sega / Westone
wb32	神奇男孩 III - Monster Lair (set 2, Japan, System 16B, FD1094 317-0085)	神奇男孩 III - Monster Lair (set 2, Japan, System 16B, FD1094 317-0085)	Sega / Westone
dduxbl	怪鸭冒险记 (盗版)	怪鸭冒险记 (盗版)	bootleg
goldnabl	战斧 (盗版)	战斧 (盗版)	bootleg
shinobl	忍 (盗版)	忍 (盗版)	bootleg
tetrisbl	俄罗斯方块 (Sega 盗版)	俄罗斯方块 (Sega 盗版)	bootleg
wb3bbl	神奇男孩 III - Monster Lair (盗版)	神奇男孩 III - Monster Lair (盗版)	bootleg
astorm	异形风暴	异形风暴	Sega
astorm3	异形风暴 (set 3, World, 3位玩家版, FD1094 317-0148)	异形风暴 (set 3, World, 3位玩家版, FD1094 317-0148)	Sega
astormu	异形风暴 (set 2, US, 3位玩家版, FD1094 317-0147)	异形风暴 (set 2, US, 3位玩家版, FD1094 317-0147)	Sega
astormj	异形风暴 (set 1, Japan, 2位玩家版, FD1094 317-0146)	异形风暴 (set 1, Japan, 2位玩家版, FD1094 317-0146)	Sega
shdancer	影舞者 (set 3, 美版)	影舞者 (set 3, 美版)	Sega
shdancej	影舞者 (set 2, 日版)	影舞者 (set 2, 日版)	Sega
shdance1	影舞者 (set 1)	影舞者 (set 1)	Sega
astormbl	异形风暴 (盗版)	异形风暴 (盗版)	bootleg
shdancbl	影舞者 (盗版)	影舞者 (盗版)	bootleg
aburner	冲破火网 (日版)	冲破火网 (日版)	Sega
aburner2	冲破火网 II	冲破火网 II	Sega
quizmeku	问答 眼花缭乱的故事	问答 眼花缭乱的故事	Sega
alien3	异形 3	异形 3	Sega
ga2	战斧 2 - Death Adder 的复仇 (世界版)	战斧 2 - Death Adder 的复仇 (世界版)	Sega
ga2u	战斧 2 - Death Adder 的复仇 (美版)	战斧 2 - Death Adder 的复仇 (美版)	Sega
ga2j	战斧 2 - Death Adder 的复仇 (日版)	战斧 2 - Death Adder 的复仇 (日版)	Sega
dbzvrvs	龙珠 Z VRVS	龙珠 Z VRVS	Sega / Banpresto
colmns97	形体方块 '97 (JET 961209 V1.000)	形体方块 '97 (JET 961209 V1.000)	Sega
diehard	刑事快打 / Dynamite 刑事 / Die Hard Arcade (美版)	刑事快打 / Dynamite 刑事 / Die Hard Arcade (美版)	Sega
dnmtdeka	刑事快打 / Dynamite 刑事 (日版)	刑事快打 / Dynamite 刑事 (日版)	Sega
groovef	豪血寺一族 3 - Groove On Fight (J 970416 V1.001)	豪血寺一族 3 - Groove On Fight (J 970416 V1.001)	Atlus
kiwames	职业麻雀 极 S (J 951020 V1.208)	职业麻雀 极 S (J 951020 V1.208)	Athena
suikoenb	水浒演武	水浒演武	Data East
karianx	魔法宝石 (Rev. 1.0)	魔法宝石 (Rev. 1.0)	Deniam
columns	形体方块 (美版)	形体方块 (美版)	Sega
columnsu	形体方块 (美版, cocktail)	形体方块 (美版, cocktail)	Sega
columnsj	形体方块 (日版)	形体方块 (日版)	Sega
columns2	形体方块 II - 时间导航 (日版)	形体方块 II - 时间导航 (日版)	Sega
column2j	形体方块 II: The Voyage Through Time (日版)	形体方块 II: The Voyage Through Time (日版)	Sega
tfrceac	雷霆力量 AC	雷霆力量 AC	Sega / Technosoft
tfrceacj	雷霆力量 AC (日版)	雷霆力量 AC (日版)	Sega / Technosoft
tfrceacb	雷霆力量 AC (盗版)	雷霆力量 AC (盗版)	bootleg
ribbit	Ribbit! - 蛤蟆园	Ribbit! - 蛤蟆园	Sega
puyopuy2	扑哟扑哟通 (日版)	扑哟扑哟通 (日版)	Compile (Sega license)
puckpkmn	小精灵: 吃豆 Pockimon	小精灵: 吃豆 Pockimon	Genie
mt_beast	兽王记	兽王记	Sega
mt_asyn	异形特攻队 (Mega-Tech)	异形特攻队 (Mega-Tech)	Sega
mt_tetri	俄罗斯方块 (Mega-Tech)	俄罗斯方块 (Mega-Tech)	Sega
mt_gng	大魔界村	大魔界村	Capcom / Sega
mt_gaxe	战斧	战斧	Sega
mt_cols	形体方块 (Mega-Tech)	形体方块 (Mega-Tech)	Sega
mt_astrm	异形风暴 (Mega-Tech	异形风暴 (Mega-Tech	Sega
mt_fshrk	鲛! 鲛! 鲛!	鲛! 鲛! 鲛!	Toaplan / Sega
mt_gaxe2	战斧 2	战斧 2	Sega
mp_gaxe2	战斧 2	战斧 2	Sega
mp_col3	形体方块 III (Mega Play)	形体方块 III (Mega Play)	Sega
ssf2ghw	超级街头霸王 II: 新挑战者 (Arcade bootleg of Japanese MegaDrive version)	超级街头霸王 II: 新挑战者 (Arcade bootleg of Japanese MegaDrive version)	bootleg / Capcom
zoar	X 任务 / 避难所	X 任务 / 避难所	Data East USA
wtennis	世界乒乓球	世界乒乓球	bootleg
astrof	宇宙飞行士 (set 1)	宇宙飞行士 (set 1)	Data East
astrof2	宇宙飞行士 (set 2)	宇宙飞行士 (set 2)	Data East
astrof3	宇宙飞行士 (set 3)	宇宙飞行士 (set 3)	Data East
abattle	宇宙飞行士 (set 1)	宇宙飞行士 (set 1)	Sidam
abattle2	宇宙飞行士 (set 2)	宇宙飞行士 (set 2)	Sidam
afire	宇宙飞行士	宇宙飞行士	Rene Pierre
acombat	宇宙飞行士 (newer, CB)	宇宙飞行士 (newer, CB)	bootleg
acombato	宇宙飞行士 (older, PZ)	宇宙飞行士 (older, PZ)	bootleg
kchamp	空手道 / Karate Champ (美版)	空手道 / Karate Champ (美版)	Data East USA
karatedo	空手道 (日版)	空手道 (日版)	Data East Corporation
kchampvs	对战空手道 青春美少女编 / Karate Champ (美版 VS version)	对战空手道 青春美少女编 / Karate Champ (美版 VS version)	Data East USA
karatevs	对战空手道 青春美少女编 (日版 VS version)	对战空手道 青春美少女编 (日版 VS version)	Data East Corporation
firetrap	烈焰陷阱 (美版)	烈焰陷阱 (美版)	Data East USA
firetpbl	烈焰陷阱 (日版 盗版)	烈焰陷阱 (日版 盗版)	bootleg
brkthru	强行突破 / Break Thru (美版)	强行突破 / Break Thru (美版)	Data East USA
brkthruj	强行突破 (日版)	强行突破 (日版)	Data East Corporation
darwin	黑暗之风 4078 (日版)	黑暗之风 4078 (日版)	Data East Corporation
exprraid	火车大盗 / 西部急行列车 (美版)	火车大盗 / 西部急行列车 (美版)	Data East USA
exprrada	火车大盗 / 西部急行列车 (美版 set 2)	火车大盗 / 西部急行列车 (美版 set 2)	Data East USA
wexpress	火车大盗 / 西部急行列车 (世界版?)	火车大盗 / 西部急行列车 (世界版?)	Data East Corporation
wexpresb	火车大盗 / 西部急行列车 (盗版 set 1)	火车大盗 / 西部急行列车 (盗版 set 1)	bootleg
wexpresc	火车大盗 / 西部急行列车 (盗版 set 2)	火车大盗 / 西部急行列车 (盗版 set 2)	bootleg
pcktgal	花式桌球 (日版)	花式桌球 (日版)	Data East Corporation
pcktgalb	花式桌球 (盗版)	花式桌球 (盗版)	bootleg
pcktgal2	花式桌球 2 (世界版?)	花式桌球 2 (世界版?)	Data East Corporation
pcktgl2j	花式桌球 2 (日文版)	花式桌球 2 (日文版)	Data East Corporation
spool3	花式桌球 / Super Pool III (世界版?)	花式桌球 / Super Pool III (世界版?)	Data East Corporation
spool3i	花式桌球 / Super Pool III (I-Vics)	花式桌球 / Super Pool III (I-Vics)	Data East Corporation (I-Vics license)
battlera	恶人战斗部队 嗜血野狼 / Battle Rangers (世界版)	恶人战斗部队 嗜血野狼 / Battle Rangers (世界版)	Data East Corporation
bldwolf	恶人战斗部队 嗜血野狼 / Bloody Wolf (美版)	恶人战斗部队 嗜血野狼 / Bloody Wolf (美版)	Data East USA
lastmisn	最终任务 (美版 revision 6)	最终任务 (美版 revision 6)	Data East USA
lastmsno	最终任务 (美版 revision 5)	最终任务 (美版 revision 5)	Data East USA
lastmsnj	最终任务 (日版)	最终任务 (日版)	Data East Corporation
ghostb	迷宫猎人 G / Real Ghost Busters (美版 2位玩家版)	迷宫猎人 G / Real Ghost Busters (美版 2位玩家版)	Data East USA
ghostb3	迷宫猎人 G / Real Ghost Busters (美版 3位玩家版)	迷宫猎人 G / Real Ghost Busters (美版 3位玩家版)	Data East USA
srdarwin	黑暗之风 2 (世界版)	黑暗之风 2 (世界版)	Data East Corporation
srdarwnj	黑暗之风 2 (日版)	黑暗之风 2 (日版)	Data East Corporation
gondo	魔境战士 / Gondomania (美版)	魔境战士 / Gondomania (美版)	Data East USA
makyosen	魔境战士 (日版)	魔境战士 (日版)	Data East Corporation
garyoret	卧龙列传 (日版)	卧龙列传 (日版)	Data East Corporation
cobracom	眼睛蛇指令 (世界版 revision 5)	眼睛蛇指令 (世界版 revision 5)	Data East Corporation
cobracmj	眼睛蛇指令 (日版)	眼睛蛇指令 (日版)	Data East Corporation
karnov	斗士的历史 - Karnov (美版)	斗士的历史 - Karnov (美版)	Data East USA
karnovj	斗士的历史 - Karnov (日版)	斗士的历史 - Karnov (日版)	Data East Corporation
wndrplnt	不思议的星球 (日版)	不思议的星球 (日版)	Data East Corporation
chelnov	原子超人 (世界版)	原子超人 (世界版)	Data East Corporation
chelnovu	原子超人 (美版)	原子超人 (美版)	Data East USA
chelnovj	原子超人 (日版)	原子超人 (日版)	Data East Corporation
hbarrel	致命武器 (美版)	致命武器 (美版)	Data East USA
hbarrelw	致命武器 (世界版)	致命武器 (世界版)	Data East Corporation
baddudes	龙行忍者 (美版)	龙行忍者 (美版)	Data East USA
drgninja	龙行忍者 (日版)	龙行忍者 (日版)	Data East Corporation
robocop	机械战警 / 铁甲威龙 (世界版 revision 4)	机械战警 / 铁甲威龙 (世界版 revision 4)	Data East Corporation
robocopw	机械战警 / 铁甲威龙 (世界版 revision 3)	机械战警 / 铁甲威龙 (世界版 revision 3)	Data East Corporation
robocopj	机械战警 / 铁甲威龙 (日版)	机械战警 / 铁甲威龙 (日版)	Data East Corporation
robocopu	机械战警 / 铁甲威龙 (美版 revision 1)	机械战警 / 铁甲威龙 (美版 revision 1)	Data East USA
robocpu0	机械战警 / 铁甲威龙 (美版 revision 0)	机械战警 / 铁甲威龙 (美版 revision 0)	Data East USA
robocopb	机械战警 / 铁甲威龙 (世界版 盗版)	机械战警 / 铁甲威龙 (世界版 盗版)	bootleg
hippodrm	激斗幻想 / Hippodrome (美版)	激斗幻想 / Hippodrome (美版)	Data East USA
ffantasy	激斗幻想 (日版 revision 2)	激斗幻想 (日版 revision 2)	Data East Corporation
ffantasa	激斗幻想 (日版)	激斗幻想 (日版)	Data East Corporation
madmotor	疯狂摩托	疯狂摩托	Mitchell
vaportra	空牙 - 行动代号 'Vapor Trail' / Vapor Trail - Hyper Offence Formation (世界版 revision 1)	空牙 - 行动代号 'Vapor Trail' / Vapor Trail - Hyper Offence Formation (世界版 revision 1)	Data East Corporation
vaportru	空牙 - 行动代号 'Vapor Trail' / Vapor Trail - Hyper Offence Formation (美版)	空牙 - 行动代号 'Vapor Trail' / Vapor Trail - Hyper Offence Formation (美版)	Data East USA
kuhga	空牙 - 行动代号 'Vapor Trail' (日版 revision 3)	空牙 - 行动代号 'Vapor Trail' (日版 revision 3)	Data East Corporation
cbuster	暴力克星 (世界版 FX version)	暴力克星 (世界版 FX version)	Data East Corporation
cbusterw	暴力克星 (世界版 FU version)	暴力克星 (世界版 FU version)	Data East Corporation
cbusterj	暴力克星 (日版)	暴力克星 (日版)	Data East Corporation
twocrude	暴力克星 / Two Crude (美版)	暴力克星 / Two Crude (美版)	Data East USA
darkseal	暗黑封印 / 毁灭之门 (世界版 revision 3)	暗黑封印 / 毁灭之门 (世界版 revision 3)	Data East Corporation
darksea1	暗黑封印 / 毁灭之门 (世界版 revision 1)	暗黑封印 / 毁灭之门 (世界版 revision 1)	Data East Corporation
darkseaj	暗黑封印 / 毁灭之门 (日版)	暗黑封印 / 毁灭之门 (日版)	Data East Corporation
gatedoom	暗黑封印 / 毁灭之门 (美版 revision 4)	暗黑封印 / 毁灭之门 (美版 revision 4)	Data East Corporation
gatedom1	暗黑封印 / 毁灭之门 (美版 revision 1)	暗黑封印 / 毁灭之门 (美版 revision 1)	Data East Corporation
cninja	战斗原始人 (世界版 revision 3)	战斗原始人 (世界版 revision 3)	Data East Corporation
cninja0	战斗原始人 (世界版 revision 0)	战斗原始人 (世界版 revision 0)	Data East Corporation
cninjau	战斗原始人 (美版)	战斗原始人 (美版)	Data East Corporation
joemac	战斗原始人 (日版)	战斗原始人 (日版)	Data East Corporation
stoneage	战斗原始人 / 石器时代	战斗原始人 / 石器时代	bootleg
robocop2	机械战警 / 铁甲威龙 2 (世界版)	机械战警 / 铁甲威龙 2 (世界版)	Data East Corporation
robocp2u	机械战警 / 铁甲威龙 2 (美版)	机械战警 / 铁甲威龙 2 (美版)	Data East Corporation
robocp2j	机械战警 / 铁甲威龙 2 (日版)	机械战警 / 铁甲威龙 2 (日版)	Data East Corporation
chinatwn	唐人街 (日版)	唐人街 (日版)	Data East Corporation
captaven	上尉密令 / Captain America (亚洲版 Rev Rev 1.9)	上尉密令 / Captain America (亚洲版 Rev Rev 1.9)	Data East Corporation
captavna	上尉密令 / Captain America (亚洲版 Rev 1.0)	上尉密令 / Captain America (亚洲版 Rev 1.0)	Data East Corporation
captavne	上尉密令 / Captain America (英国版 Rev 1.4)	上尉密令 / Captain America (英国版 Rev 1.4)	Data East Corporation
captavnu	上尉密令 / Captain America (美版 Rev 1.9)	上尉密令 / Captain America (美版 Rev 1.9)	Data East Corporation
captavuu	上尉密令 / Captain America (美版 Rev 1.6)	上尉密令 / Captain America (美版 Rev 1.6)	Data East Corporation
captavnj	上尉密令 / Captain America (日版 Rev 0.2)	上尉密令 / Captain America (日版 Rev 0.2)	Data East Corporation
tumblep	捉鬼大师 (世界版)	捉鬼大师 (世界版)	Data East Corporation
tumblepj	捉鬼大师 (日版)	捉鬼大师 (日版)	Data East Corporation
tumbleb	捉鬼大师 (盗版 set 1)	捉鬼大师 (盗版 set 1)	bootleg
tumbleb2	捉鬼大师 (盗版 set 2)	捉鬼大师 (盗版 set 2)	bootleg
wizdfire	暗黑封印 / 毁灭之门 2 / Wizard Fire (美版 v1.1)	暗黑封印 / 毁灭之门 2 / Wizard Fire (美版 v1.1)	Data East Corporation
darksel2	暗黑封印 / 毁灭之门 2 (日版 v2.1)	暗黑封印 / 毁灭之门 2 (日版 v2.1)	Data East Corporation
fghthist	斗士的历史 (美版)	斗士的历史 (美版)	Data East Corporation
fghthstu	斗士的历史 (美版 ver 42-03)	斗士的历史 (美版 ver 42-03)	Data East Corporation
fghthsta	斗士的历史 (美版 ver 42-05, alternate hardware )	斗士的历史 (美版 ver 42-05, alternate hardware )	Data East Corporation
tattass	纹身刺客 (美版 工程版)	纹身刺客 (美版 工程版)	Data East Pinball
tattassa	纹身刺客 (亚洲版 工程版)	纹身刺客 (亚洲版 工程版)	Data East Pinball
sotsugyo	卒业证书	卒业证书	Mitchell (Atlus license)
sshangha	超级上海 龙之眼 (日版)	超级上海 龙之眼 (日版)	Hot-B.
sshanghb	超级上海 龙之眼 (世界版, 盗版)	超级上海 龙之眼 (世界版, 盗版)	bootleg
starforc	星际武力	星际武力	Tehkan
starfore	星际武力 (encrypted)	星际武力 (encrypted)	Tehkan
megaforc	星际武力 / Mega Force	星际武力 / Mega Force	Tehkan (Video Ware license)
solomon	所罗门之钥 (日版)	所罗门之钥 (日版)	Tecmo
rygar	阿尔卑斯古战士 (美版 set 1)	阿尔卑斯古战士 (美版 set 1)	Tecmo
rygar2	阿尔卑斯古战士 (美版 set 2)	阿尔卑斯古战士 (美版 set 2)	Tecmo
rygarj	阿尔卑斯古战士 (日版)	阿尔卑斯古战士 (日版)	Tecmo
gemini	捉虫敢死队 / 双子星 / 昆虫世界	捉虫敢死队 / 双子星 / 昆虫世界	Tecmo
silkworm	联合大作战 (set 1)	联合大作战 (set 1)	Tecmo
silkwrm2	联合大作战 (set 2)	联合大作战 (set 2)	Tecmo
shadoww	忍者龙剑传 / Shadow Warriors (世界版 set 1)	忍者龙剑传 / Shadow Warriors (世界版 set 1)	Tecmo
shadowwa	忍者龙剑传 / Shadow Warriors (世界版 set 2)	忍者龙剑传 / Shadow Warriors (世界版 set 2)	Tecmo
gaiden	忍者龙剑传 / 忍者外传 (美版)	忍者龙剑传 / 忍者外传 (美版)	Tecmo
ryukendn	忍者龙剑传 (日版)	忍者龙剑传 (日版)	Tecmo
stratof	雷牙 - Storato Fighter (美版)	雷牙 - Storato Fighter (美版)	Tecmo
raiga	雷牙 - Storato Fighter (日版)	雷牙 - Storato Fighter (日版)	Tecmo
wc90	世界杯 '90 (set 1)	世界杯 '90 (set 1)	Tecmo
wc90a	世界杯 '90 (set 2)	世界杯 '90 (set 2)	Tecmo
wc90t	世界杯 '90 (trackball)	世界杯 '90 (trackball)	Tecmo
wc90b	世界杯 '90 / 欧洲联盟	世界杯 '90 / 欧洲联盟	bootleg
fstarfrc	最终星际武力 (美版)	最终星际武力 (美版)	Tecmo
psurge	电路小精灵	电路小精灵	<unknown>
pandoras	潘多拉之殿	潘多拉之殿	Konami/Interlogic
hyperspt	Konami 运动会'84	Konami 运动会'84	Konami (Centuri license)
sbasketb	超级篮球 (version G)	超级篮球 (version G)	Konami
sbasketo	超级篮球 (version E)	超级篮球 (version E)	Konami
sbasketu	超级篮球 (未加密)	超级篮球 (未加密)	Konami
mikie	新入社员 Tooru 君 / Mikie	新入社员 Tooru 君 / Mikie	Konami
mikiej	新入社员 Tooru 君	新入社员 Tooru 君	Konami
mikiehs	新入社员 Tooru 君 / Mikie (高校涂鸦)	新入社员 Tooru 君 / Mikie (高校涂鸦)	Konami
yiear	功夫小子 (set 1)	功夫小子 (set 1)	Konami
yiear2	功夫小子 (set 2)	功夫小子 (set 2)	Konami
kicker	少林之道 / Kicker	少林之道 / Kicker	Konami
shaolins	少林之道 / Shao-Lin's Road	少林之道 / Shao-Lin's Road	Konami
pingpong	乒乓球	乒乓球	Konami
gberet	绿色兵团	绿色兵团	Konami
rushatck	绿色兵团 / Rush'n Attack (美版)	绿色兵团 / Rush'n Attack (美版)	Konami
gberetb	绿色兵团 (盗版)	绿色兵团 (盗版)	bootleg
mrgoemon	Mr.五右卫门 (日版)	Mr.五右卫门 (日版)	Konami
jailbrek	曼哈顿 24 分局 / 越狱	曼哈顿 24 分局 / 越狱	Konami
manhatan	曼哈顿 24 分局 (日版)	曼哈顿 24 分局 (日版)	Konami
ironhors	火车大盗 / Iron Horse	火车大盗 / Iron Horse	Konami
dairesya	火车大盗 (日版)	火车大盗 (日版)	[Konami] (Kawakusu license)
farwest	火车大盗 / 遥远西部	火车大盗 / 遥远西部	bootleg?
jackal	赤色要塞 / 特殊部队 豺 / Jackal (世界版)	赤色要塞 / 特殊部队 豺 / Jackal (世界版)	Konami
topgunr	赤色要塞 / 特殊部队 豺 / Top Gunner (美版)	赤色要塞 / 特殊部队 豺 / Top Gunner (美版)	Konami
jackalj	赤色要塞 / 特殊部队 豺 (日版)	赤色要塞 / 特殊部队 豺 (日版)	Konami
topgunbl	赤色要塞 / 特殊部队 豺 / Top Gunner (盗版)	赤色要塞 / 特殊部队 豺 / Top Gunner (盗版)	bootleg
contra	魂斗罗 (美版)	魂斗罗 (美版)	Konami
contrab	魂斗罗 (美版 盗版)	魂斗罗 (美版 盗版)	bootleg
contraj	魂斗罗 (日版)	魂斗罗 (日版)	Konami
contrajb	魂斗罗 (日版 盗版)	魂斗罗 (日版 盗版)	bootleg
gryzor	魂斗罗 / Gryzor (Set 1)	魂斗罗 / Gryzor (Set 1)	Konami
gryzora	魂斗罗 / Gryzor (Set 2)	魂斗罗 / Gryzor (Set 2)	Konami
rockrage	恋爱热摇滚 / Rock 'n Rage (盗版?)	恋爱热摇滚 / Rock 'n Rage (盗版?)	Konami
rockraga	恋爱热摇滚 / Rock 'n Rage (工程版?)	恋爱热摇滚 / Rock 'n Rage (工程版?)	Konami
rockragj	恋爱热摇滚 (日版)	恋爱热摇滚 (日版)	Konami
hcastle	恶魔城 Dracula / Haunted Castle (version M)	恶魔城 Dracula / Haunted Castle (version M)	Konami
hcastleo	恶魔城 (version K)	恶魔城 (version K)	Konami
hcastlej	恶魔城 Dracula (日版 version P)	恶魔城 Dracula (日版 version P)	Konami
hcastljo	恶魔城 (日版 version N)	恶魔城 (日版 version N)	Konami
ajax	飓风直升机 / Ajax	飓风直升机 / Ajax	Konami
typhoon	飓风直升机	飓风直升机	Konami
ajaxj	飓风直升机 / Ajax (日版)	飓风直升机 / Ajax (日版)	Konami
scontra	超级魂斗罗	超级魂斗罗	Konami
scontraj	超级魂斗罗 (日版)	超级魂斗罗 (日版)	Konami
thunderx	雷霆战机	雷霆战机	Konami
thnderxa	雷霆战机 (Set 2)	雷霆战机 (Set 2)	Konami
thnderxb	雷霆战机 (Set 3)	雷霆战机 (Set 3)	Konami
thnderxj	雷霆战机 (日版)	雷霆战机 (日版)	Konami
mainevt	Ring 之王者 / The Main Event (4位玩家版 ver. Y)	Ring 之王者 / The Main Event (4位玩家版 ver. Y)	Konami
mainevto	Ring 之王者 / The Main Event (4位玩家版 ver. F)	Ring 之王者 / The Main Event (4位玩家版 ver. F)	Konami
mainev2p	Ring 之王者 / The Main Event (2位玩家版 ver. X)	Ring 之王者 / The Main Event (2位玩家版 ver. X)	Konami
ringohja	Ring 之王者 (日版)	Ring 之王者 (日版)	Konami
devstors	饿流祸 / 破坏者 (ver. Z)	饿流祸 / 破坏者 (ver. Z)	Konami
devstor2	饿流祸 / 破坏者 (ver. X)	饿流祸 / 破坏者 (ver. X)	Konami
devstor3	饿流祸 / 破坏者 (ver. V)	饿流祸 / 破坏者 (ver. V)	Konami
garuka	饿流祸 (日版 ver. W)	饿流祸 (日版 ver. W)	Konami
gbusters	疯狂警察 / Gang Busters	疯狂警察 / Gang Busters	Konami
crazycop	疯狂警察 (日版)	疯狂警察 (日版)	Konami
crimfght	罪恶战士 (美版 4位玩家版)	罪恶战士 (美版 4位玩家版)	Konami
crimfgt2	罪恶战士 (世界版 2位玩家版)	罪恶战士 (世界版 2位玩家版)	Konami
crimfgtj	罪恶战士 (日版 2位玩家版)	罪恶战士 (日版 2位玩家版)	Konami
spy	S.P.Y. - 特别计划 Y (世界版 ver. N)	S.P.Y. - 特别计划 Y (世界版 ver. N)	Konami
spyu	S.P.Y. - 特别计划 Y (美版 ver. M))	S.P.Y. - 特别计划 Y (美版 ver. M))	Konami
aliens	异形 (世界版 set 1)	异形 (世界版 set 1)	Konami
aliens2	异形 (世界版 set 2)	异形 (世界版 set 2)	Konami
aliens3	异形 (世界版 set 3)	异形 (世界版 set 3)	Konami
aliensu	异形 (美版)	异形 (美版)	Konami
aliensj	异形 (日版)	异形 (日版)	Konami
aliensj2	异形 (日版 set 2)	异形 (日版 set 2)	Konami
parodius	Q版沙罗曼蛇 (世界版)	Q版沙罗曼蛇 (世界版)	Konami
parodisj	Q版沙罗曼蛇 (日版)	Q版沙罗曼蛇 (日版)	Konami
vendetta	复仇 2 / Vendetta (世界版 4位玩家版 ver. T)	复仇 2 / Vendetta (世界版 4位玩家版 ver. T)	Konami
vendetao	复仇 2 / Vendetta (世界版 4位玩家版 ver. R)	复仇 2 / Vendetta (世界版 4位玩家版 ver. R)	Konami
vendet2p	复仇 2 / Vendetta (世界版 2位玩家版 ver. W)	复仇 2 / Vendetta (世界版 2位玩家版 ver. W)	Konami
vendetas	复仇 2 / Vendetta (亚洲版 2位玩家版 ver. U)	复仇 2 / Vendetta (亚洲版 2位玩家版 ver. U)	Konami
vendtaso	复仇 2 / Vendetta (亚洲版 2位玩家版 ver. D)	复仇 2 / Vendetta (亚洲版 2位玩家版 ver. D)	Konami
vendettj	复仇 2 / Crime Fighters 2 (日版 2位玩家版 ver. P)	复仇 2 / Crime Fighters 2 (日版 2位玩家版 ver. P)	Konami
hotchase	公路热击	公路热击	Konami
ultraman	咸蛋超人 - 空想特撮系列(日版)	咸蛋超人 - 空想特撮系列(日版)	Banpresto/Bandai
nemesis	宇宙巡航机 / 复仇女神	宇宙巡航机 / 复仇女神	Konami
nemesuk	宇宙巡航机 / 复仇女神 (世界版?)	宇宙巡航机 / 复仇女神 (世界版?)	Konami
salamand	沙罗曼蛇 (version D)	沙罗曼蛇 (version D)	Konami
salamanj	沙罗曼蛇 (version J)	沙罗曼蛇 (version J)	Konami
lifefrce	沙罗曼蛇 / 生命力量 (美版)	沙罗曼蛇 / 生命力量 (美版)	Konami
lifefrcj	沙罗曼蛇 / 生命力量 (日版)	沙罗曼蛇 / 生命力量 (日版)	Konami
twinbee	兵蜂	兵蜂	Konami
gradius	宇宙巡航机	宇宙巡航机	Konami
gwarrior	银河战士	银河战士	Konami
devilw	魔兽王国 / Devil World	魔兽王国 / Devil World	Konami
darkadv	魔兽王国 / Dark Adventure	魔兽王国 / Dark Adventure	Konami
majuu	魔兽王国	魔兽王国	Konami
vulcan	宇宙巡航机 II - Gofer 的野心 / Vulcan Venture	宇宙巡航机 II - Gofer 的野心 / Vulcan Venture	Konami
gradius2	宇宙巡航机 II - Gofer 的野心 (日版 新版.)	宇宙巡航机 II - Gofer 的野心 (日版 新版.)	Konami
grdius2a	宇宙巡航机 II - Gofer 的野心 (日版 旧版.)	宇宙巡航机 II - Gofer 的野心 (日版 旧版.)	Konami
grdius2b	宇宙巡航机 II - Gofer 的野心 (日版 Older Ver.)	宇宙巡航机 II - Gofer 的野心 (日版 Older Ver.)	Konami
miaj	绿色兵团 2 (日版)	绿色兵团 2 (日版)	Konami
mia	绿色兵团 2 (version T)	绿色兵团 2 (version T)	Konami
mia2	绿色兵团 2 (version S)	绿色兵团 2 (version S)	Konami
tmnt	忍者神龟 (世界版 4位玩家版)	忍者神龟 (世界版 4位玩家版)	Konami
tmntu	忍者神龟 (美版 4位玩家版)	忍者神龟 (美版 4位玩家版)	Konami
tmntua	忍者神龟 (美版 4位玩家版, set 2)	忍者神龟 (美版 4位玩家版, set 2)	Konami
tmht	忍者神龟 / T.M.H.T. (英国版 4位玩家版)	忍者神龟 / T.M.H.T. (英国版 4位玩家版)	Konami
tmntj	忍者神龟 (日版 4位玩家版)	忍者神龟 (日版 4位玩家版)	Konami
tmht2p	忍者神龟 / T.M.H.T. (英国版 2位玩家版)	忍者神龟 / T.M.H.T. (英国版 2位玩家版)	Konami
tmht2pa	忍者神龟 (UK 2位玩家版, set 2)	忍者神龟 (UK 2位玩家版, set 2)	Konami
tmnt2pj	忍者神龟 (日版 2位玩家版)	忍者神龟 (日版 2位玩家版)	Konami
tmnt2po	忍者神龟 (大洋洲版 2位玩家版)	忍者神龟 (大洋洲版 2位玩家版)	Konami
lgtnfght	火龙 / Lightning Fighters (世界版)	火龙 / Lightning Fighters (世界版)	Konami
lgtnfghu	火龙 / Lightning Fighters (美版)	火龙 / Lightning Fighters (美版)	Konami
trigon	火龙 (日版)	火龙 (日版)	Konami
blswhstl	出发!! 兵蜂 / Bells & Whistles (Version L)	出发!! 兵蜂 / Bells & Whistles (Version L)	Konami
detatwin	出发!! 兵蜂 (日版 ver. J)	出发!! 兵蜂 (日版 ver. J)	Konami
tmnt2	忍者神龟 2 - Turtles in Time (美版 4位玩家版 ver. UAA)	忍者神龟 2 - Turtles in Time (美版 4位玩家版 ver. UAA)	Konami
tmnt2a	忍者神龟 2 - Turtles in Time (亚洲版 4位玩家版 ver. ADA)	忍者神龟 2 - Turtles in Time (亚洲版 4位玩家版 ver. ADA)	Konami
tmht22pe	忍者神龟 2 - Turtles in Time (2位玩家版 ver EBA)	忍者神龟 2 - Turtles in Time (2位玩家版 ver EBA)	Konami
tmnt22pu	忍者神龟 2 - Turtles in Time (2位玩家版 ver UDA)	忍者神龟 2 - Turtles in Time (2位玩家版 ver UDA)	Konami
ssriders	落日骑士 / 西部牛仔 (4位玩家版 ver EAC)	落日骑士 / 西部牛仔 (4位玩家版 ver EAC)	Konami
ssrdrebd	落日骑士 / 西部牛仔 (2位玩家版 ver EBD)	落日骑士 / 西部牛仔 (2位玩家版 ver EBD)	Konami
ssrdrebc	落日骑士 / 西部牛仔 (2位玩家版 ver EBC)	落日骑士 / 西部牛仔 (2位玩家版 ver EBC)	Konami
ssrdruda	落日骑士 / 西部牛仔 (4位玩家版 ver UDA)	落日骑士 / 西部牛仔 (4位玩家版 ver UDA)	Konami
ssrdreaa	落日骑士 / 西部牛仔 (4位玩家版 ver EAA)	落日骑士 / 西部牛仔 (4位玩家版 ver EAA)	Konami
ssrdruac	落日骑士 / 西部牛仔 (4位玩家版 ver UAC)	落日骑士 / 西部牛仔 (4位玩家版 ver UAC)	Konami
ssrdrubc	落日骑士 / 西部牛仔 (2位玩家版 ver UBC)	落日骑士 / 西部牛仔 (2位玩家版 ver UBC)	Konami
ssrdrabd	落日骑士 / 西部牛仔 (2位玩家版 ver ABD)	落日骑士 / 西部牛仔 (2位玩家版 ver ABD)	Konami
ssrdradd	落日骑士 / 西部牛仔 (4位玩家版 ver ADD)	落日骑士 / 西部牛仔 (4位玩家版 ver ADD)	Konami
ssrdrjbd	落日骑士 / 西部牛仔 (2位玩家版 ver JBD)	落日骑士 / 西部牛仔 (2位玩家版 ver JBD)	Konami
sunsetbl	落日骑士 / 西部牛仔 (盗版 4位玩家版 ver ADD)	落日骑士 / 西部牛仔 (盗版 4位玩家版 ver ADD)	Konami
asterix	高卢奇兵 (ver EAD)	高卢奇兵 (ver EAD)	Konami
astrxeac	高卢奇兵 (ver EAC)	高卢奇兵 (ver EAC)	Konami
astrxeaa	高卢奇兵 (ver EAA)	高卢奇兵 (ver EAA)	Konami
gijoe	特种部队 (世界版)	特种部队 (世界版)	Konami
gijoeu	特种部队 (美版)	特种部队 (美版)	Konami
gijoej	特种部队 (日版)	特种部队 (日版)	Konami
thndrx2	雷霆战机 II (日版)	雷霆战机 II (日版)	Konami
thndrx2a	雷霆战机 II (亚洲版)	雷霆战机 II (亚洲版)	Konami
prmrsocr	顶级足球 (ver EAB)	顶级足球 (ver EAB)	Konami
prmrsocj	顶级足球 (ver JAB)	顶级足球 (ver JAB)	Konami
qgakumon	问答 学问之 Susume (日版 ver. JA2 Type L)	问答 学问之 Susume (日版 ver. JA2 Type L)	Konami
bucky	宇宙野兔 (世界版 version EA)	宇宙野兔 (世界版 version EA)	Konami
buckyua	宇宙野兔 (美版 version UA)	宇宙野兔 (美版 version UA)	Konami
gaiapols	Gaiapolis - 黄金鹰之剑 (日版 ver JAF)	Gaiapolis - 黄金鹰之剑 (日版 ver JAF)	Konami
dadandrn	究极战队 Dadandarn (ver JAA)	究极战队 Dadandarn (ver JAA)	Konami
dbz	龙珠 Z	龙珠 Z	Banpresto
dbz2	龙珠 Z 2 Super Battle	龙珠 Z 2 Super Battle	Banpresto
gradius3	宇宙巡航机 III - 传说神话 (日版)	宇宙巡航机 III - 传说神话 (日版)	Konami
grdius3a	宇宙巡航机 III - 传说神话 (亚洲版)	宇宙巡航机 III - 传说神话 (亚洲版)	Konami
grdius3e	宇宙巡航机 III - 传说神话 (世界版 ?)	宇宙巡航机 III - 传说神话 (世界版 ?)	Konami
puzldama	对战 解迷球 (Ver JAA)	对战 解迷球 (Ver JAA)	Konami
gokuparo	极上沙罗曼蛇 (ver JAD)	极上沙罗曼蛇 (ver JAD)	Konami
fantjour	极上沙罗曼蛇 / 幻想之旅	极上沙罗曼蛇 / 幻想之旅	Konami
tbyahhoo	兵蜂 Yahhoo! (Ver JAA)	兵蜂 Yahhoo! (Ver JAA)	Konami
tkmmpzdm	心跳回忆 对战解迷球 (日版 version JAB)	心跳回忆 对战解迷球 (日版 version JAB)	Konami
salmndr2	沙罗曼蛇 2 (JAA)	沙罗曼蛇 2 (JAA)	Konami
sexyparo	性感沙罗曼蛇 (Ver JAA)	性感沙罗曼蛇 (Ver JAA)	Konami
daiskiss	最爱 Kiss (Ver JAA)	最爱 Kiss (Ver JAA)	Konami
tokkae	对战 Tokkae 解迷球 (日版 Ver JAA)	对战 Tokkae 解迷球 (日版 Ver JAA)	Konami
chiller	毛骨悚然 (version 3.0)	毛骨悚然 (version 3.0)	Exidy
topsecex	最高机密 (Exidy) (version 1.0)	最高机密 (Exidy) (version 1.0)	Exidy
destroyr	驱逐舰	驱逐舰	Atari
ultratnk	终极坦克	终极坦克	Atari
bsktball	篮球	篮球	Atari
abaseb	Atari 棒球 (set 1)	Atari 棒球 (set 1)	Atari
abaseb2	Atari 棒球 (set 2)	Atari 棒球 (set 2)	Atari
missile	导弹指令 (set 1)	导弹指令 (set 1)	Atari
missile2	导弹指令 (set 2)	导弹指令 (set 2)	Atari
suprmatk	小精灵: 吃豆女士 / Super Missile Attack	小精灵: 吃豆女士 / Super Missile Attack	Atari + Gencomp
tempest	暴风雨 (rev 3)	暴风雨 (rev 3)	Atari
tempest1	暴风雨 (rev 1)	暴风雨 (rev 1)	Atari
tempest2	暴风雨 (rev 2)	暴风雨 (rev 2)	Atari
tempest3	暴风雨 (rev 2, Revised Hardware)	暴风雨 (rev 2, Revised Hardware)	Atari
temptube	暴风雨 Tubes	暴风雨 Tubes	hack
starwars	星球大战 (rev 2)	星球大战 (rev 2)	Atari
starwar1	星球大战 (rev 1)	星球大战 (rev 1)	Atari
esb	星球大战 - 帝国的反击	星球大战 - 帝国的反击	Atari Games
foodf	食物大战 (rev 3)	食物大战 (rev 3)	Atari
foodf2	食物大战 (rev 2)	食物大战 (rev 2)	Atari
foodfc	食物大战 (cocktail)	食物大战 (cocktail)	Atari
ccastles	水晶城堡 (version 4)	水晶城堡 (version 4)	Atari
ccastleg	水晶城堡 (version 3, 德国版)	水晶城堡 (version 3, 德国版)	Atari
ccastlep	水晶城堡 (version 3, Spanish)	水晶城堡 (version 3, Spanish)	Atari
ccastlef	水晶城堡 (version 3, French)	水晶城堡 (version 3, French)	Atari
ccastle3	水晶城堡 (version 3)	水晶城堡 (version 3)	Atari
ccastle2	水晶城堡 (version 2)	水晶城堡 (version 2)	Atari
ccastle1	水晶城堡 (version 1)	水晶城堡 (version 1)	Atari
jedi	星球大战 - Jedi 归来	星球大战 - Jedi 归来	Atari
marble	疯狂弹珠 (set 1)	疯狂弹珠 (set 1)	Atari Games
marble2	疯狂弹珠 (set 2)	疯狂弹珠 (set 2)	Atari Games
marble3	疯狂弹珠 (set 3)	疯狂弹珠 (set 3)	Atari Games
marble4	疯狂弹珠 (set 4)	疯狂弹珠 (set 4)	Atari Games
indytemp	圣战奇兵 / Indiana Jones 和毁灭之殿 (set 1)	圣战奇兵 / Indiana Jones 和毁灭之殿 (set 1)	Atari Games
indytem2	圣战奇兵 / Indiana Jones 和毁灭之殿 (set 2)	圣战奇兵 / Indiana Jones 和毁灭之殿 (set 2)	Atari Games
indytem3	圣战奇兵 / Indiana Jones 和毁灭之殿 (set 3)	圣战奇兵 / Indiana Jones 和毁灭之殿 (set 3)	Atari Games
indytem4	圣战奇兵 / Indiana Jones 和毁灭之殿 (set 4)	圣战奇兵 / Indiana Jones 和毁灭之殿 (set 4)	Atari Games
indytemd	圣战奇兵 / Indiana Jones 和毁灭之殿 (德国版)	圣战奇兵 / Indiana Jones 和毁灭之殿 (德国版)	Atari Games
indytemc	圣战奇兵 / Indiana Jones 和毁灭之殿 (Cocktail)	圣战奇兵 / Indiana Jones 和毁灭之殿 (Cocktail)	Atari Games
apb	APB 全国大搜查 (rev 7)	APB 全国大搜查 (rev 7)	Atari Games
apb6	APB 全国大搜查 (rev 6)	APB 全国大搜查 (rev 6)	Atari Games
apb5	APB 全国大搜查 (rev 5)	APB 全国大搜查 (rev 5)	Atari Games
apb4	APB 全国大搜查 (rev 4)	APB 全国大搜查 (rev 4)	Atari Games
apb3	APB 全国大搜查 (rev 3)	APB 全国大搜查 (rev 3)	Atari Games
apb2	APB 全国大搜查 (rev 2)	APB 全国大搜查 (rev 2)	Atari Games
apb1	APB 全国大搜查 (rev 1)	APB 全国大搜查 (rev 1)	Atari Games
apbg	APB 全国大搜查 (德文)	APB 全国大搜查 (德文)	Atari Games
apbf	APB 全国大搜查 (法文)	APB 全国大搜查 (法文)	Atari Games
atetcktl	俄罗斯方块 (Cocktail set 1)	俄罗斯方块 (Cocktail set 1)	Atari Games
atetckt2	俄罗斯方块 (Cocktail set 2)	俄罗斯方块 (Cocktail set 2)	Atari Games
atetris	俄罗斯方块 (set 1)	俄罗斯方块 (set 1)	Atari Games
atetrisa	俄罗斯方块 (set 2)	俄罗斯方块 (set 2)	Atari Games
atetrisb	俄罗斯方块 (盗版)	俄罗斯方块 (盗版)	bootleg
atetrsb2	俄罗斯方块 (盗版 set 2)	俄罗斯方块 (盗版 set 2)	bootleg
eprom	机械怪兽大逃亡 (set 1)	机械怪兽大逃亡 (set 1)	Atari Games
eprom2	机械怪兽大逃亡 (set 2)	机械怪兽大逃亡 (set 2)	Atari Games
pitfight	角斗士 (rev 5)	角斗士 (rev 5)	Atari Games
pitfigh4	角斗士 (rev 4)	角斗士 (rev 4)	Atari Games
pitfigh3	角斗士 (rev 3)	角斗士 (rev 3)	Atari Games
pitfighj	角斗士 (日版, 2位玩家版)	角斗士 (日版, 2位玩家版)	Atari Games
pitfighb	角斗士 (盗版)	角斗士 (盗版)	Atari Games
batman	蝙蝠侠	蝙蝠侠	Atari Games
relief	替补投手 (set 1)	替补投手 (set 1)	Atari Games
relief2	替补投手 (set 2)	替补投手 (set 2)	Atari Games
arcadecl	街机经典名作 (工程版)	街机经典名作 (工程版)	Atari Games
fantasy	幻想 (美版)	幻想 (美版)	SNK
fantasyu	幻想 (美版)	幻想 (美版)	[SNK] (Rock-Ola license)
fantasyj	幻想 (日版)	幻想 (日版)	SNK
sgladiat	剑斗士 1984	剑斗士 1984	SNK
aso	ASO - 组合战机	ASO - 组合战机	SNK
tnk3	大坦克 (美版)	大坦克 (美版)	SNK
tnk3j	大坦克 (日版)	大坦克 (日版)	SNK
athena	雅典娜	雅典娜	SNK
fitegolf	战斗高尔夫 (世界版?)	战斗高尔夫 (世界版?)	SNK
fitegol2	战斗高尔夫 (美版)	战斗高尔夫 (美版)	SNK
countryc	国家俱乐部	国家俱乐部	SNK
ikari	怒 (美版)	怒 (美版)	SNK
ikarijp	怒 (日版)	怒 (日版)	SNK
ikarijpb	怒 (日版 盗版)	怒 (日版 盗版)	bootleg
victroad	怒号层圈 / 胜利之路	怒号层圈 / 胜利之路	SNK
dogosoke	怒号层圈 (日版)	怒号层圈 (日版)	SNK
dogosokj	怒号层圈 (Joystick bootleg)	怒号层圈 (Joystick bootleg)	bootleg
gwar	古巴战士 / 革命英雄 (美版)	古巴战士 / 革命英雄 (美版)	SNK
gwarj	古巴战士 / 革命英雄 (日版)	古巴战士 / 革命英雄 (日版)	SNK
gwara	古巴战士 / 革命英雄 (Version 1)	古巴战士 / 革命英雄 (Version 1)	SNK
gwarb	古巴战士 / 革命英雄 (盗版)	古巴战士 / 革命英雄 (盗版)	bootleg
bermudat	百慕大魔鬼三角 (日版)	百慕大魔鬼三角 (日版)	SNK
bermudao	百慕大魔鬼三角 (日版 旧版)	百慕大魔鬼三角 (日版 旧版)	SNK
bermudaa	百慕大魔鬼三角 (美版 older version)	百慕大魔鬼三角 (美版 older version)	SNK
worldwar	世界大战 (世界版)	世界大战 (世界版)	SNK
psychos	超能力战士 (美版)	超能力战士 (美版)	SNK
psychosj	超能力战士 (日版)	超能力战士 (日版)	SNK
chopper	航空骑兵物语 / Chopper I (美版 set 1)	航空骑兵物语 / Chopper I (美版 set 1)	SNK
choppera	航空骑兵物语 / Chopper I (美版 set 2)	航空骑兵物语 / Chopper I (美版 set 2)	SNK
chopperb	航空骑兵物语 / Chopper I (美版 set 3)	航空骑兵物语 / Chopper I (美版 set 3)	SNK
legofair	航空骑兵物语 - The Legend of Air Cavalry (日版)	航空骑兵物语 - The Legend of Air Cavalry (日版)	SNK
ikari3	怒 III - The Rescue	怒 III - The Rescue	SNK
ikari3nr	怒 III - The Rescue (8-Way Joystick)	怒 III - The Rescue (8-Way Joystick)	SNK
pow	脱狱 - 战俘 / P.O.W. (美版)	脱狱 - 战俘 / P.O.W. (美版)	SNK
powj	脱狱 - 战俘 (日版)	脱狱 - 战俘 (日版)	SNK
searchar	异型大作战 / SAR - 搜救 (世界版)	异型大作战 / SAR - 搜救 (世界版)	SNK
sercharu	异型大作战 / SAR - 搜救 (美版)	异型大作战 / SAR - 搜救 (美版)	SNK
sercharj	异型大作战 / SAR - 搜救 (日版)	异型大作战 / SAR - 搜救 (日版)	SNK
prehisle	原始岛 1930 (世界版)	原始岛 1930 (世界版)	SNK
prehislu	原始岛 1930 (美版)	原始岛 1930 (美版)	SNK of America
gensitou	原始岛	原始岛	SNK
nam1975	越战-1975	越战-1975	SNK
bstars	棒球之星 专业版	棒球之星 专业版	SNK
tpgolf	顶尖高尔夫	顶尖高尔夫	SNK
mahretsu	麻雀狂列传 西日本篇	麻雀狂列传 西日本篇	SNK
maglord	幻魔大战 (set 1)	幻魔大战 (set 1)	Alpha Denshi Co.
maglordh	幻魔大战 (set 2)	幻魔大战 (set 2)	Alpha Denshi Co.
ridhero	风速英雄 (set 1)	风速英雄 (set 1)	SNK
ridheroh	风速英雄 (set 2)	风速英雄 (set 2)	SNK
alpham2	阿尔法 任务 / ASO II - 最后的守护神	阿尔法 任务 / ASO II - 最后的守护神	SNK
ncombat	忍者大战 (set 1)	忍者大战 (set 1)	Alpha Denshi Co.
ncombata	忍者大战 (set 2)	忍者大战 (set 2)	Alpha Denshi Co.
cyberlip	战斗边缘	战斗边缘	SNK
superspy	谍报飞龙	谍报飞龙	SNK
mutnat	外星游龙 / 变异种族	外星游龙 / 变异种族	SNK
kotm	魔兽之王 (set 1)	魔兽之王 (set 1)	SNK
kotmh	魔兽之王 (set 2)	魔兽之王 (set 2)	SNK
sengoku	战国传承 (set 1)	战国传承 (set 1)	SNK
sengokh	战国传承 (set 2)	战国传承 (set 2)	SNK
burningf	热血快打 (set 1)	热血快打 (set 1)	SNK
burningh	热血快打 (set 2)	热血快打 (set 2)	SNK
lbowling	爆笑保龄球	爆笑保龄球	SNK
gpilots	魔鬼战将 / 幽灵战区	魔鬼战将 / 幽灵战区	SNK
joyjoy	阳光方块	阳光方块	SNK
bjourney	蓝色之旅 / 拉吉少年	蓝色之旅 / 拉吉少年	Alpha Denshi Co.
quizdais	问答 大搜查线 - 最后倒计时	问答 大搜查线 - 最后倒计时	SNK
lresort	终极手段	终极手段	SNK
eightman	8 号超人	8 号超人	SNK / Pallas
minasan	麻雀大富翁	麻雀大富翁	Monolith Corp.
legendos	传说之虎	传说之虎	SNK
2020bb	2020 年超级棒球 (set 1)	2020 年超级棒球 (set 1)	SNK / Pallas
2020bba	2020 年超级棒球 (set 2)	2020 年超级棒球 (set 2)	SNK / Pallas
2020bbh	2020 年超级棒球 (set 3)	2020 年超级棒球 (set 3)	SNK / Pallas
socbrawl	机器人足球	机器人足球	SNK
roboarmy	机甲神兵 (set 1)	机甲神兵 (set 1)	SNK
roboarma	机甲神兵 (set 2)	机甲神兵 (set 2)	SNK
fatfury1	饿狼传说 - 宿命之战	饿狼传说 - 宿命之战	SNK
fbfrenzy	疯狂美式足球	疯狂美式足球	SNK
bakatono	傻瓜殿下: 麻雀漫游记	傻瓜殿下: 麻雀漫游记	Monolith Corp.
crsword	圣十字剑	圣十字剑	Alpha Denshi Co.
trally	极速英豪	极速英豪	Alpha Denshi Co.
kotm2	魔兽之王 2	魔兽之王 2	SNK
sengoku2	战国传承 2	战国传承 2	SNK
bstars2	棒球之星2	棒球之星2	SNK
quizdai2	问答 大搜查线 Part 2 - 问答迷侦探 Neo & Geo	问答 大搜查线 Part 2 - 问答迷侦探 Neo & Geo	SNK
3countb	火线摔跤	火线摔跤	SNK
aof	龙虎之拳	龙虎之拳	SNK
samsho	侍魂	侍魂	SNK
tophuntr	顶尖猎人 - Roddy & Cathy (set 1)	顶尖猎人 - Roddy & Cathy (set 1)	SNK
tophunta	顶尖猎人 - Roddy & Cathy (set 2)	顶尖猎人 - Roddy & Cathy (set 2)	SNK
fatfury2	饿狼传说 2 - 新的战斗	饿狼传说 2 - 新的战斗	SNK
janshin	雀神传说 - Quest of Jongmaster	雀神传说 - Quest of Jongmaster	Aicom
androdun	勇者之击	勇者之击	Visco
ncommand	忍者战士	忍者战士	Alpha Denshi Co.
viewpoin	观点战机	观点战机	Sammy
ssideki	得点王	得点王	SNK
wh1	世界英雄 (set 1)	世界英雄 (set 1)	Alpha Denshi Co.
wh1h	世界英雄 (set 2)	世界英雄 (set 2)	Alpha Denshi Co.
kof94	拳皇 '94	拳皇 '94	SNK
aof2	龙虎之拳 2 (set 1)	龙虎之拳 2 (set 1)	SNK
aof2a	龙虎之拳 2 (set 2)	龙虎之拳 2 (set 2)	SNK
wh2	世界英雄 2	世界英雄 2	ADK
fatfursp	饿狼传说 特别版 (set 1)	饿狼传说 特别版 (set 1)	SNK
fatfursa	饿狼传说 特别版 (set 2)	饿狼传说 特别版 (set 2)	SNK
savagere	风云默示录 - 格斗创世	风云默示录 - 格斗创世	SNK
fightfev	狂热格斗 (set 1)	狂热格斗 (set 1)	Viccom
fightfva	狂热格斗 (set 2)	狂热格斗 (set 2)	Viccom
ssideki2	得点王 2 - 实战足球	得点王 2 - 实战足球	SNK
spinmast	滑轮大师 / 强尼大冒险	滑轮大师 / 强尼大冒险	Data East Corporation
samsho2	侍魂 II / 真侍魂 - 霸王丸地狱变	侍魂 II / 真侍魂 - 霸王丸地狱变	SNK
wh2j	世界英雄 2 Jet	世界英雄 2 Jet	ADK / SNK
wjammers	野外排球 / 超级飞碟球	野外排球 / 超级飞碟球	Data East Corporation
karnovr	斗士的历史 - Karnov 的复仇	斗士的历史 - Karnov 的复仇	Data East Corporation
gururin	旋转方块	旋转方块	Face
pspikes2	能量排球 2	能量排球 2	Video System Co.
fatfury3	饿狼传说 3 - 远古征战	饿狼传说 3 - 远古征战	SNK
zupapa	星星大作战!	星星大作战!	SNK
panicbom	炸弹人方块 / 炸弹危机	炸弹人方块 / 炸弹危机	Eighting / Hudson
aodk	痛快 GANGAN 进行曲 / 热血进行曲	痛快 GANGAN 进行曲 / 热血进行曲	ADK / SNK
sonicwi2	音速之翼 2 / 四国战机 2	音速之翼 2 / 四国战机 2	Video System Co.
zedblade	Z 字军刀 / 末日之战	Z 字军刀 / 末日之战	NMK
galaxyfg	银河快打 / 星系格斗	银河快打 / 星系格斗	Sunsoft
strhoop	街头篮球	街头篮球	Data East Corporation
quizkof	拳皇问答	拳皇问答	Saurus
ssideki3	得点王 3 - 光荣的挑战	得点王 3 - 光荣的挑战	SNK
doubledr	双截龙 (Neo-Geo)	双截龙 (Neo-Geo)	Technos
pbobblen	泡泡龙 / Bust-A-Move (Neo-Geo) (set 1)	泡泡龙 / Bust-A-Move (Neo-Geo) (set 1)	Taito
pbobblna	泡泡龙 / Bust-A-Move (Neo-Geo) (set 2)	泡泡龙 / Bust-A-Move (Neo-Geo) (set 2)	Taito
kof95	拳皇 '95 (set 1)	拳皇 '95 (set 1)	SNK
kof95a	拳皇 '95 (set 2)	拳皇 '95 (set 2)	SNK
tws96	Tecmo 世界杯足球 '96	Tecmo 世界杯足球 '96	Tecmo
samsho3	侍魂 III - 斩红郎无双剑 (set 1)	侍魂 III - 斩红郎无双剑 (set 1)	SNK
samsho3a	侍魂 III - 斩红郎无双剑 (set 2)	侍魂 III - 斩红郎无双剑 (set 2)	SNK
fswords	侍魂 III - 斩红郎无双剑 (韩文版)	侍魂 III - 斩红郎无双剑 (韩文版)	SNK
stakwin	赛马大亨 / 赏金猎手 - GI 完全制霸之道	赛马大亨 / 赏金猎手 - GI 完全制霸之道	Saurus
pulstar	死亡之星 / 惑星战机	死亡之星 / 惑星战机	Aicom
whp	世界英雄 完美版	世界英雄 完美版	ADK / SNK
kabukikl	天外魔境真传 - 东方伊甸园	天外魔境真传 - 东方伊甸园	Hudson
neobombe	炸弹人: Neo 机皇版	炸弹人: Neo 机皇版	Hudson
gowcaizr	超人学园钢帝王	超人学园钢帝王	Technos
rbff1	Real Bout 饿狼传说	Real Bout 饿狼传说	SNK
aof3	龙虎之拳 3 - 战士的道路 / 龙虎之拳 外传	龙虎之拳 3 - 战士的道路 / 龙虎之拳 外传	SNK
aof3k	龙虎之拳 3 - 战士的道路 / 龙虎之拳 外传 (韩文 release)	龙虎之拳 3 - 战士的道路 / 龙虎之拳 外传 (韩文 release)	SNK
sonicwi3	音速之翼 3 / 四国战机 3	音速之翼 3 / 四国战机 3	Video System Co.
turfmast	大联盟高尔夫	大联盟高尔夫	Nazca
mslug	合金弹头 - 超级战车-001	合金弹头 - 超级战车-001	Nazca
puzzledp	解谜气泡	解谜气泡	Taito (Visco license)
mosyougi	将棋达人	将棋达人	ADK / SNK
marukodq	小丸子问答	小丸子问答	Takara
neomrdo	Neo Do!先生	Neo Do!先生	Visco
sdodgeb	超级躲避球 / 热血斗球传说	超级躲避球 / 热血斗球传说	Technos
goalx3	射门! 射门! 射门!	射门! 射门! 射门!	Visco
zintrckb	生物泡泡 (hack / 盗版)	生物泡泡 (hack / 盗版)	hack
overtop	极速赛车	极速赛车	ADK
neodrift	Neo 越野赛车	Neo 越野赛车	Visco
kof96	拳皇 '96 (set 1)	拳皇 '96 (set 1)	SNK
kof96h	拳皇 '96 (set 2)	拳皇 '96 (set 2)	SNK
ssideki4	得点王 4 - 火炎之 Libero	得点王 4 - 火炎之 Libero	SNK
kizuna	风云默示录 2 - 超级组队战	风云默示录 2 - 超级组队战	SNK
ninjamas	霸王忍法帖	霸王忍法帖	ADK / SNK
ragnagrd	神凰拳	神凰拳	Saurus
pgoal	开心射门 / Futsal - 5 对 5 迷你足球	开心射门 / Futsal - 5 对 5 迷你足球	Saurus
magdrop2	魔法气泡 II	魔法气泡 II	Data East Corporation
samsho4	侍魂 IV - 天草降临	侍魂 IV - 天草降临	SNK
rbffspec	Real Bout 饿狼传说 特别版	Real Bout 饿狼传说 特别版	SNK
twinspri	梦幻小妖精	梦幻小妖精	ADK
wakuwak7	火热火热 7	火热火热 7	Sunsoft
stakwin2	赛马大亨 / 赏金猎手 2	赛马大亨 / 赏金猎手 2	Saurus
ghostlop	幽灵球 (工程版)	幽灵球 (工程版)	Data East Corporation
breakers	爆烈人	爆烈人	Visco
miexchng	金钱游戏	金钱游戏	Face
kof97	拳皇 '97 (set 1)	拳皇 '97 (set 1)	SNK
kof97a	拳皇 '97 (set 2)	拳皇 '97 (set 2)	SNK
kof97pls	拳皇 '97 风云再起加强版 (盗版)	拳皇 '97 风云再起加强版 (盗版)	bootleg
kog	格斗之王 (盗版)	格斗之王 (盗版)	bootleg
magdrop3	魔法气泡 III	魔法气泡 III	Data East Corporation
lastblad	幕末浪漫 月华剑士 (set 1)	幕末浪漫 月华剑士 (set 1)	SNK
lastbldh	幕末浪漫 月华剑士 (set 2)	幕末浪漫 月华剑士 (set 2)	SNK
lastsold	幕末浪漫 月华剑士 (韩文版)	幕末浪漫 月华剑士 (韩文版)	SNK
puzzldpr	解谜气泡 R	解谜气泡 R	Taito (Visco license)
irrmaze	终极电流急急棒	终极电流急急棒	SNK / Saurus
popbounc	跳跳球 / 动物方块	跳跳球 / 动物方块	Video System Co.
shocktro	突击骑兵 / 震惊骑兵 (set 1)	突击骑兵 / 震惊骑兵 (set 1)	Saurus
shocktra	突击骑兵 / 震惊骑兵 (set 2)	突击骑兵 / 震惊骑兵 (set 2)	Saurus
blazstar	闪亮之星 / 炽热星空	闪亮之星 / 炽热星空	Yumekobo
rbff2	Real Bout 饿狼传说 2 - 新的来者 (set 1)	Real Bout 饿狼传说 2 - 新的来者 (set 1)	SNK
rbff2h	Real Bout 饿狼传说 2 - 新的来者 (set 2)	Real Bout 饿狼传说 2 - 新的来者 (set 2)	SNK
rbff2k	Real Bout 饿狼传说 2 - 新的来者 (韩文 release)	Real Bout 饿狼传说 2 - 新的来者 (韩文 release)	SNK
mslug2	合金弹头 2 - 超级战车-001/II	合金弹头 2 - 超级战车-001/II	SNK
kof98	拳皇 '98 - 梦战斗未结束	拳皇 '98 - 梦战斗未结束	SNK
kof98k	拳皇 '98 - 梦战斗未结束 (韩文基板)	拳皇 '98 - 梦战斗未结束 (韩文基板)	SNK
kof98n	拳皇 '98 - 梦战斗未结束 (未加密)	拳皇 '98 - 梦战斗未结束 (未加密)	SNK
lastbld2	幕末浪漫第二幕 月华剑士 - 月中芳华,散落月下	幕末浪漫第二幕 月华剑士 - 月中芳华,散落月下	SNK
neocup98	Neogeo 杯 '98  - 胜利之路	Neogeo 杯 '98  - 胜利之路	SNK
breakrev	爆烈人 复仇	爆烈人 复仇	Visco
shocktr2	突击骑兵 / 震惊骑兵 - 第二纵队	突击骑兵 / 震惊骑兵 - 第二纵队	Saurus
lans2004	雇佣兵 (盗版)	雇佣兵 (盗版)	bootleg
flipshot	盾牌大战	盾牌大战	Visco
pbobbl2n	泡泡龙 2 / Bust-A-Move Again (Neo-Geo)	泡泡龙 2 / Bust-A-Move Again (Neo-Geo)	Taito (SNK license)
ctomaday	番茄超人	番茄超人	Visco
mslugx	合金弹头 X - 超级战车-001	合金弹头 X - 超级战车-001	SNK
kof99	拳皇 '99 - 千年之战 (set 1)	拳皇 '99 - 千年之战 (set 1)	SNK
kof99a	拳皇 '99 - 千年之战 (set 2)	拳皇 '99 - 千年之战 (set 2)	SNK
kof99e	拳皇 '99 - 千年之战 (earlier)	拳皇 '99 - 千年之战 (earlier)	SNK
kof99n	拳皇 '99 - 千年之战 (未加密)	拳皇 '99 - 千年之战 (未加密)	SNK
kof99p	拳皇 '99 - 千年之战 (工程版)	拳皇 '99 - 千年之战 (工程版)	SNK
ganryu	武藏严流记 / 武藏传说 	武藏严流记 / 武藏传说 	Visco
garou	饿狼 - 群狼之证 / 狼之烙印 (set 1)	饿狼 - 群狼之证 / 狼之烙印 (set 1)	SNK
garouo	饿狼 - 群狼之证 / 狼之烙印 (set 2)	饿狼 - 群狼之证 / 狼之烙印 (set 2)	SNK
garoup	饿狼 - 群狼之证 / 狼之烙印 (工程版)	饿狼 - 群狼之证 / 狼之烙印 (工程版)	SNK
garoubl	饿狼 - 群狼之证 / 狼之烙印 (盗版)	饿狼 - 群狼之证 / 狼之烙印 (盗版)	bootleg
s1945p	打击者 1945 加强版	打击者 1945 加强版	Psikyo
preisle2	原始岛 2	原始岛 2	Yumekobo
mslug3	合金弹头 3	合金弹头 3	SNK
mslug3n	合金弹头 3 (未加密 P)	合金弹头 3 (未加密 P)	SNK
mslug3b6	合金弹头 6 (盗版)	合金弹头 6 (盗版)	bootleg
kof2000	拳皇 2000	拳皇 2000	SNK
kof2000n	拳皇 2000 (未加密)	拳皇 2000 (未加密)	SNK
bangbead	碰碰球	碰碰球	Visco
nitd	黑暗守墓者 / 暗黑恶梦	黑暗守墓者 / 暗黑恶梦	Eleven / Gavaking
sengoku3	战国传承 3 / 战国传承 2001	战国传承 3 / 战国传承 2001	SNK
kof2001	拳皇 2001 (set 1)	拳皇 2001 (set 1)	Eolith / SNK
kof2001h	拳皇 2001 (set 2)	拳皇 2001 (set 2)	Eolith / SNK
cthd2003	卧虎藏龙 2003 (set 1)	卧虎藏龙 2003 (set 1)	bootleg
ct2k3sp	卧虎藏龙 风云 2003 超级加强 (盗版)	卧虎藏龙 风云 2003 超级加强 (盗版)	bootleg
mslug4	合金弹头 4	合金弹头 4	Mega
ms4plus	合金弹头 4 增强型加强版 (盗版)	合金弹头 4 增强型加强版 (盗版)	bootleg
rotd	龙吼 - 双截龙	龙吼 - 双截龙	Evoga / Playmore
kof2002	拳皇 2002 - 终极挑战	拳皇 2002 - 终极挑战	Eolith / Playmore
kf2k2pls	拳皇 2002 - 终极挑战 风云再起 (set 1, 盗版)	拳皇 2002 - 终极挑战 风云再起 (set 1, 盗版)	bootleg
kf2k2pla	拳皇 2002 - 终极挑战 风云再起加强版 (set 2, 盗版)	拳皇 2002 - 终极挑战 风云再起加强版 (set 2, 盗版)	bootleg
kf2k2mp	拳皇 2002 - 终极挑战 魔法加强版 (盗版)	拳皇 2002 - 终极挑战 魔法加强版 (盗版)	bootleg
kf2k2mp2	拳皇 2002 - 终极挑战 魔法加强版 II (盗版)	拳皇 2002 - 终极挑战 魔法加强版 II (盗版)	bootleg
kof10th	拳皇 10 周年 - 所有队伍的战斗 (盗版)	拳皇 10 周年 - 所有队伍的战斗 (盗版)	bootleg
kf2k5uni	拳皇 10 周年 - 所有队伍的战斗 2005 独特版 (盗版)	拳皇 10 周年 - 所有队伍的战斗 2005 独特版 (盗版)	bootleg
kf10thep	拳皇 10 周年 - 所有队伍的战斗 额外加强版 (盗版)	拳皇 10 周年 - 所有队伍的战斗 额外加强版 (盗版)	bootleg
kof2k4se	拳皇 特别版 2004 (盗版)	拳皇 特别版 2004 (盗版)	bootleg
matrim	斗婚 / 新豪血寺一族	斗婚 / 新豪血寺一族	Noise Factory / Atlus
pnyaa	宠物方块	宠物方块	Aiky / Taito
ms5pcb	合金弹头 5 (JAMMA PCB)	合金弹头 5 (JAMMA PCB)	SNK Playmore
mslug5	合金弹头 5	合金弹头 5	SNK Playmore
ms5plus	合金弹头 5 加强版 (盗版)	合金弹头 5 加强版 (盗版)	bootleg
svcpcb	Svc混沌: Snk 对 Capcom (JAMMA PCB)	Svc混沌: Snk 对 Capcom (JAMMA PCB)	Playmore
svcpcba	Svc混沌: Snk 对 Capcom (JAMMA PCB, set 2)	Svc混沌: Snk 对 Capcom (JAMMA PCB, set 2)	Playmore
svc	Svc混沌: Snk 对 Capcom (MVS)	Svc混沌: Snk 对 Capcom (MVS)	Playmore
svcboot	Svc混沌: Snk 对 Capcom (盗版)	Svc混沌: Snk 对 Capcom (盗版)	bootleg
svcplus	Svc混沌: Snk 对 Capcom 加强 (盗版 set 1)	Svc混沌: Snk 对 Capcom 加强 (盗版 set 1)	bootleg
svcplusa	Svc混沌: Snk 对 Capcom 加强 (盗版 set 2)	Svc混沌: Snk 对 Capcom 加强 (盗版 set 2)	bootleg
svcsplus	Svc混沌: Snk 对 Capcom 超级加强 (盗版)	Svc混沌: Snk 对 Capcom 超级加强 (盗版)	bootleg
samsho5	侍魂 V / 侍魂 Zero (set 1)	侍魂 V / 侍魂 Zero (set 1)	Yuki Enterprise / SNK Playmore
samsho5h	侍魂 V / 侍魂 Zero (set 2)	侍魂 V / 侍魂 Zero (set 2)	Yuki Enterprise / SNK Playmore
samsho5b	侍魂 V / 侍魂 Zero (盗版)	侍魂 V / 侍魂 Zero (盗版)	bootleg
kf2k3pcb	拳皇 2003 (日版, JAMMA PCB)	拳皇 2003 (日版, JAMMA PCB)	SNK Playmore
kof2003	拳皇 2003 (世界版 / 美版, MVS)	拳皇 2003 (世界版 / 美版, MVS)	SNK Playmore
kf2k3bl	拳皇 2003 (盗版, set 1)	拳皇 2003 (盗版, set 1)	bootleg
kf2k3bla	拳皇 2003 (盗版, set 2)	拳皇 2003 (盗版, set 2)	bootleg
kf2k3pl	拳皇 2004 EX 英雄 (盗版)	拳皇 2004 EX 英雄 (盗版)	bootleg
kf2k3upl	拳皇 2004 EX 风云加强 (盗版)	拳皇 2004 EX 风云加强 (盗版)	bootleg
samsh5sp	侍魂 V 特别版 / 侍魂 Zero 特别版 (set 1)	侍魂 V 特别版 / 侍魂 Zero 特别版 (set 1)	Yuki Enterprise / SNK Playmore
samsh5sh	侍魂 V 特别版 / 侍魂 Zero 特别版 (set 2)	侍魂 V 特别版 / 侍魂 Zero 特别版 (set 2)	Yuki Enterprise / SNK Playmore
samsh5sn	侍魂 V 特别版 / 侍魂 Zero 特别版 (set 3)	侍魂 V 特别版 / 侍魂 Zero 特别版 (set 3)	Yuki Enterprise / SNK Playmore
jockeygp	赌马大赛	赌马大赛	Sun Amusement / BrezzaSoft
vliner	水果机 (set 1)	水果机 (set 1)	Dyna / BreezaSoft
vlinero	水果机 (set 2)	水果机 (set 2)	Dyna / BreezaSoft
diggerma	挖地先生	挖地先生	Kyle Hodgetts
champbas	冠军棒球	冠军棒球	Sega
champbbj	冠军棒球 (日版)	冠军棒球 (日版)	Alpha Denshi Co.
champbja	冠军棒球 (日版 set 2)	冠军棒球 (日版 set 2)	Alpha Denshi Co.
champbb2	冠军棒球 II	冠军棒球 II	Sega
champb2a	冠军棒球 II (set 2)	冠军棒球 II (set 2)	Alpha Denshi Co.
exctsccr	激情足球	激情足球	Alpha Denshi Co.
exctscca	激情足球 (alternate music)	激情足球 (alternate music)	Alpha Denshi Co.
exctsccb	激情足球 (盗版)	激情足球 (盗版)	bootleg
exctscc2	激情足球 / Exciting Soccer II	激情足球 / Exciting Soccer II	Alpha Denshi Co.
kouyakyu	高校棒球	高校棒球	Alpha Denshi Co.
skysoldr	空中骑士 (美版)	空中骑士 (美版)	[Alpha Denshi Co.] (SNK of America/Romstar license)
skyadvnt	天空大冒险 (世界版)	天空大冒险 (世界版)	Alpha Denshi Co.
skyadvnu	天空大冒险 (美版)	天空大冒险 (美版)	Alpha Denshi Co. (SNK of America license)
skyadvnj	天空大冒险 (日版)	天空大冒险 (日版)	Alpha Denshi Co.
gangwars	群殴 (美版)	群殴 (美版)	Alpha Denshi Co.
gangwarb	群殴 (盗版)	群殴 (盗版)	bootleg
sbasebal	超级冠军篮球 (美版)	超级冠军篮球 (美版)	Alpha Denshi Co. (SNK of America license)
ssozumo	出世大相扑 (日版)	出世大相扑 (日版)	Technos
mystston	秘石 (set 1)	秘石 (set 1)	Technos
myststno	秘石 (set 2)	秘石 (set 2)	Technos
matmania	激情时刻 / Mat Mania	激情时刻 / Mat Mania	Technos (Taito America license)
excthour	激情时刻 (日版)	激情时刻 (日版)	Technos (Taito license)
renegade	热血硬派 国夫君 / 叛徒 (美版)	热血硬派 国夫君 / 叛徒 (美版)	Technos (Taito America license)
kuniokun	热血硬派 国夫君 (日版)	热血硬派 国夫君 (日版)	Technos
kuniokub	热血硬派 国夫君 (日版 盗版)	热血硬派 国夫君 (日版 盗版)	bootleg
ddragon	双截龙 (日版)	双截龙 (日版)	Technos
ddragonu	双截龙 (美版)	双截龙 (美版)	[Technos] (Taito America license)
ddragoua	双截龙 (美版 Set 2)	双截龙 (美版 Set 2)	[Technos] (Taito America license)
ddragonw	双截龙 (世界版 Set 1)	双截龙 (世界版 Set 1)	[Technos] (Taito license)
ddragnw1	双截龙 (世界版 Set 2)	双截龙 (世界版 Set 2)	[Technos] (Taito license)
ddragonb	双截龙 (盗版)	双截龙 (盗版)	bootleg
spdodgeb	热血高校躲避球部 / 超级躲避球 (美版)	热血高校躲避球部 / 超级躲避球 (美版)	Technos
nkdodgeb	热血高校躲避球部 (日版 盗版)	热血高校躲避球部 (日版 盗版)	Technos
chinagat	西游降魔禄 / 中华门 (美版)	西游降魔禄 / 中华门 (美版)	[Technos] (Taito Romstar license)
saiyugou	西游降魔录 - 流棒妖技之章 (日版)	西游降魔录 - 流棒妖技之章 (日版)	Technos
saiyugb1	西游降魔录 - 流棒妖技之章 (日版 盗版 1)	西游降魔录 - 流棒妖技之章 (日版 盗版 1)	bootleg
saiyugb2	西游降魔录 - 流棒妖技之章 (日版 盗版 2)	西游降魔录 - 流棒妖技之章 (日版 盗版 2)	bootleg
wwfsstar	WWF 超级明星 (美版)	WWF 超级明星 (美版)	Technos Japan
wwfsstaa	WWF 超级明星 (美版, Newer)	WWF 超级明星 (美版, Newer)	Technos Japan
wwfsstau	WWF 超级明星 (美版)	WWF 超级明星 (美版)	Technos Japan
wwfsstaj	WWF 超级明星 (日版)	WWF 超级明星 (日版)	Technos Japan
vball	美国沙滩排球锦标赛 (set 1)	美国沙滩排球锦标赛 (set 1)	Technos
vball2pj	美国沙滩排球锦标赛 (日版)	美国沙滩排球锦标赛 (日版)	Technos
ddragon2	双截龙 II - 复仇 (世界版)	双截龙 II - 复仇 (世界版)	Technos
ddragn2u	双截龙 II - 复仇 (美版)	双截龙 II - 复仇 (美版)	Technos
ctribe	战斗部落 (美版)	战斗部落 (美版)	Technos
ctribeb	战斗部落 (盗版)	战斗部落 (盗版)	bootleg
ddragon3	双截龙 3 - Rosetta 之石	双截龙 3 - Rosetta 之石	Technos
ddrago3j	双截龙 3 - The Rosetta Stone (日版)	双截龙 3 - The Rosetta Stone (日版)	Technos
ddrago3b	双截龙 3 - Rosetta 之石 (盗版)	双截龙 3 - Rosetta 之石 (盗版)	bootleg
wwfwfest	WWF 狂热摔角 (美版)	WWF 狂热摔角 (美版)	Technos Japan
wwfwfsta	WWF 狂热摔角 (美版 Tecmo)	WWF 狂热摔角 (美版 Tecmo)	Technos Japan (Tecmo license)
wwfwfstb	WWF 狂热摔角 (美版 盗版)	WWF 狂热摔角 (美版 盗版)	bootleg
wwfwfstj	WWF 狂热摔角 (日版)	WWF 狂热摔角 (日版)	Technos Japan
shadfrce	变身忍者 (美版)	变身忍者 (美版)	Technos Japan
sia2650	宇宙侵略者 / Super Invader Attack	宇宙侵略者 / Super Invader Attack	Zaccaria/Zelco
tinv2650	宇宙侵略者 / 入侵者	宇宙侵略者 / 入侵者	Zaccaria/Zelco
ninjakun	忍者君 魔城冒险	忍者君 魔城冒险	[UPL] (Taito license)
raiders5	袭击者5	袭击者5	UPL
raidrs5t	袭击者5 (日版)	袭击者5 (日版)	UPL (Taito license)
pkunwar	企鹅小作战 (美版)	企鹅小作战 (美版)	UPL
pkunwarj	企鹅小作战 (日版)	企鹅小作战 (日版)	UPL
xxmissio	XX 任务	XX 任务	UPL
ninjakd2	忍者君 阿修罗之章 (set 1)	忍者君 阿修罗之章 (set 1)	UPL
ninjak2a	忍者君 阿修罗之章 (set 2)	忍者君 阿修罗之章 (set 2)	UPL
ninjak2b	忍者君 阿修罗之章 (set 3)	忍者君 阿修罗之章 (set 3)	UPL
rdaction	忍者君 阿修罗之章	忍者君 阿修罗之章	UPL (World Games license)
robokid	原子机械人	原子机械人	UPL
robokidj	原子机械人 (日版)	原子机械人 (日版)	UPL
robokdj2	原子机械人 (日版, Set 2)	原子机械人 (日版, Set 2)	UPL
omegaf	Omega 战机	Omega 战机	UPL
omegafs	Omega 战机 特别版	Omega 战机 特别版	UPL
mustang	野马战机 / US AAF Mustang (日版)	野马战机 / US AAF Mustang (日版)	UPL
mustangs	野马战机 / US AAF Mustang (汉城贸易)	野马战机 / US AAF Mustang (汉城贸易)	UPL (Seoul Trading license)
mustangb	野马战机 / US AAF Mustang (盗版)	野马战机 / US AAF Mustang (盗版)	bootleg
bioship	宇宙战舰 Gomora / 生化艇游侠	宇宙战舰 Gomora / 生化艇游侠	UPL (American Sammy license)
blkhearj	暗黑之心 (日版)	暗黑之心 (日版)	UPL
acrobatm	风云战机	风云战机	UPL (Taito license)
strahl	钢铁要塞 Strahl (日版 set 1)	钢铁要塞 Strahl (日版 set 1)	UPL
strahla	钢铁要塞 Strahl (日版 set 2)	钢铁要塞 Strahl (日版 set 2)	UPL
tdragon2	雷龙 2	雷龙 2	NMK
bigbang	雷龙 2 / Big Bang	雷龙 2 / Big Bang	NMK
tdragon	雷龙	雷龙	NMK (Tecmo license)
tdragonb	雷龙 (盗版)	雷龙 (盗版)	NMK / Tecmo
macross	超时空要塞 Macross	超时空要塞 Macross	Banpresto
macross2	超时空要塞 Macross II	超时空要塞 Macross II	Banpresto
nouryoku	脑力向上委员会	脑力向上委员会	Tecmo
macrossp	超时空要塞 Plus	超时空要塞 Plus	Banpresto
quizmoon	美少女战士问答 - 智力 体力 时运	美少女战士问答 - 智力 体力 时运	Banpresto
gakupara	问答 学园天国 (日版)	问答 学园天国 (日版)	NMK
quizdna	问答 DNA 叛乱 (日版)	问答 DNA 叛乱 (日版)	Face
gekiretu	问答 激乱 - 学园天国 2 (日版)	问答 激乱 - 学园天国 2 (日版)	Face
narc	毒品搜查官 (rev 7.00)	毒品搜查官 (rev 7.00)	Williams
narc3	毒品搜查官 (rev 3.20)	毒品搜查官 (rev 3.20)	Williams
mk	真人快打 (rev 5.0 T-Unit 03/19/93)	真人快打 (rev 5.0 T-Unit 03/19/93)	Midway
mkr4	真人快打 (rev 4.0 T-Unit 02/11/93)	真人快打 (rev 4.0 T-Unit 02/11/93)	Midway
mkprot9	真人快打 (工程版, rev 9.0 07/28/92)	真人快打 (工程版, rev 9.0 07/28/92)	Midway
mkla1	真人快打 (rev 1.0 08/09/92)	真人快打 (rev 1.0 08/09/92)	Midway
mkla2	真人快打 (rev 2.0 08/18/92)	真人快打 (rev 2.0 08/18/92)	Midway
mkla3	真人快打 (rev 3.0 08/31/92)	真人快打 (rev 3.0 08/31/92)	Midway
mkla4	真人快打 (rev 4.0 09/28/92)	真人快打 (rev 4.0 09/28/92)	Midway
mkyawdim	真人快打 (Yawdim 盗版)	真人快打 (Yawdim 盗版)	Midway
term2	终结者 2 - 世界末日 (rev LA3 03/27/92)	终结者 2 - 世界末日 (rev LA3 03/27/92)	Midway
term2la2	终结者 2 - 世界末日 (rev LA2 12/09/91)	终结者 2 - 世界末日 (rev LA2 12/09/91)	Midway
term2la1	终结者 2 - 世界末日 (rev LA1 11/01/91)	终结者 2 - 世界末日 (rev LA1 11/01/91)	Midway
mk2	真人快打 II (rev L3.1)	真人快打 II (rev L3.1)	Midway
mk2r32	真人快打 II (rev L3.2 (欧洲版an))	真人快打 II (rev L3.2 (欧洲版an))	Midway
mk2r21	真人快打 II (rev L2.1)	真人快打 II (rev L2.1)	Midway
mk2r14	真人快打 II (rev L1.4)	真人快打 II (rev L1.4)	Midway
mk2r42	真人快打 II (rev L4.2, hack)	真人快打 II (rev L4.2, hack)	hack
mk2r91	真人快打 II (rev L9.1, hack)	真人快打 II (rev L9.1, hack)	hack
mk2chal	真人快打 II 挑战者 (hack)	真人快打 II 挑战者 (hack)	hack
nbajam	NBA 篮球 (rev 3.01 04/07/93)	NBA 篮球 (rev 3.01 04/07/93)	Midway
nbajamr2	NBA 篮球 (rev 2.00 02/10/93)	NBA 篮球 (rev 2.00 02/10/93)	Midway
nbajamte	NBA 篮球 TE (rev 4.0 03/23/94)	NBA 篮球 TE (rev 4.0 03/23/94)	Midway
nbajamt1	NBA 篮球 TE (rev 1.0 01/17/94)	NBA 篮球 TE (rev 1.0 01/17/94)	Midway
nbajamt2	NBA 篮球 TE (rev 2.0 01/28/94)	NBA 篮球 TE (rev 2.0 01/28/94)	Midway
nbajamt3	NBA 篮球 TE (rev 3.0 03/04/94)	NBA 篮球 TE (rev 3.0 03/04/94)	Midway
revx	X 革命	X 革命	Midway
mk3	真人快打 III (rev 2.1)	真人快打 III (rev 2.1)	Midway
mk3r20	真人快打 III (rev 2.0)	真人快打 III (rev 2.0)	Midway
mk3r10	真人快打 III (rev 1.0)	真人快打 III (rev 1.0)	Midway
umk3	终极真人快打 III (rev 1.2)	终极真人快打 III (rev 1.2)	Midway
umk3r11	终极真人快打 III (rev 1.1)	终极真人快打 III (rev 1.1)	Midway
umk3r10	终极真人快打 III (rev 1.0)	终极真人快打 III (rev 1.0)	Midway
wwfmania	WWF: 疯狂摔角 (rev 1.30 08/10/95)	WWF: 疯狂摔角 (rev 1.30 08/10/95)	Midway
wwfmanib	WWF: 疯狂摔角 (rev 1.20 08/02/95)	WWF: 疯狂摔角 (rev 1.20 08/02/95)	Midway
nbahangt	NBA 篮球 悬空瞬间 (rev L1.1 04/16/96)	NBA 篮球 悬空瞬间 (rev L1.1 04/16/96)	Midway
armora	武装袭击	武装袭击	Cinematronics
armorap	武装袭击 (工程版)	武装袭击 (工程版)	Cinematronics
armorar	武装袭击 (Rock-ola)	武装袭击 (Rock-ola)	Cinematronics (Rock-ola license)
cchasm	天裂 (set 1)	天裂 (set 1)	Cinematronics / GCE
cchasm1	天裂 (set 2)	天裂 (set 2)	Cinematronics / GCE
sbagman	小精灵: 超级吃豆	小精灵: 超级吃豆	Valadon Automation
sbagmans	小精灵: 超级吃豆 (Stern)	小精灵: 超级吃豆 (Stern)	Valadon Automation (Stern license)
kungfut	功夫大君	功夫大君	Seibu Kaihatsu Inc.
kungfuta	功夫大君 (alt)	功夫大君 (alt)	Seibu Kaihatsu Inc.
empcity	帝都:1931 (盗版?)	帝都:1931 (盗版?)	Seibu Kaihatsu
empcityu	帝都: 1931 (美版)	帝都: 1931 (美版)	[Seibu Kaihatsu] (Taito / Romstar license)
empcityj	帝都:1931 (日版)	帝都:1931 (日版)	[Seibu Kaihatsu] (Taito license)
stfight	街斗 (德国版)	街斗 (德国版)	Seibu Kaihatsu
stfighta	街斗	街斗	Seibu Kaihatsu
dynduke	爆破公爵	爆破公爵	Seibu Kaihatsu
dyndukf	爆破公爵 (美版)	爆破公爵 (美版)	Seibu Kaihatsu (Fabtek license)
dbldyn	爆破公爵 / The Double Dynamites	爆破公爵 / The Double Dynamites	Seibu Kaihatsu
dbldynf	爆破公爵 / The Double Dynamites (美版)	爆破公爵 / The Double Dynamites (美版)	Seibu Kaihatsu (Fabtek license)
raiden	雷电	雷电	Seibu Kaihatsu
raidena	雷电 (互换硬件)	雷电 (互换硬件)	Seibu Kaihatsu
raidenk	雷电 (韩国版)	雷电 (韩国版)	Seibu Kaihatsu (IBL Corporation license)
raident	雷电 (台湾版)	雷电 (台湾版)	Seibu Kaihatsu (Liang HWA Electronics license)
sdgndmps	SD 高达 - Psycho Salamander 的威胁	SD 高达 - Psycho Salamander 的威胁	Banpresto / Bandai
sengokmj	战国麻将 (日版)	战国麻将 (日版)	Sigma
raiden2	雷电 2 (set 1, US Fabtek)	雷电 2 (set 1, US Fabtek)	Seibu Kaihatsu
raiden2a	雷电 2 (set 2, Metrotainment)	雷电 2 (set 2, Metrotainment)	Seibu Kaihatsu
raiden2b	雷电 2 (set 3, Japan)	雷电 2 (set 3, Japan)	Seibu Kaihatsu
raiden2c	雷电 2 (set 4, Japan)	雷电 2 (set 4, Japan)	Seibu Kaihatsu
raiden2e	雷电 2 (easier?)	雷电 2 (easier?)	Seibu Kaihatsu
raidndx	雷电 DX (set 1)	雷电 DX (set 1)	Seibu Kaihatsu
raidndxa	雷电 DX (set 2)	雷电 DX (set 2)	Seibu Kaihatsu
raidndxb	雷电 DX (set 3, Newer V33 PCB)	雷电 DX (set 3, Newer V33 PCB)	Seibu Kaihatsu
raidndxj	雷电 DX (日版)	雷电 DX (日版)	Seibu Kaihatsu
raidndxm	雷电 DX (Metrotainment license)	雷电 DX (Metrotainment license)	Seibu Kaihatsu
zeroteam	零组 (set 1)	零组 (set 1)	Seibu Kaihatsu
zeroteaa	零组 (set 2)	零组 (set 2)	Seibu Kaihatsu
zeroteab	零组 (set 3)	零组 (set 3)	Seibu Kaihatsu
nzerotea	新零组	新零组	Seibu Kaihatsu
rdft	雷电战士 (日版 set 1)	雷电战士 (日版 set 1)	Seibu Kaihatsu
rdftu	雷电战士 (美版)	雷电战士 (美版)	Seibu Kaihatsu (Fabtek license)
rdftau	雷电战士 (澳洲)	雷电战士 (澳洲)	Seibu Kaihatsu
rdftj	雷电战士 (日版 set 2)	雷电战士 (日版 set 2)	Seibu Kaihatsu
rdftdi	雷电战士 (Dream Island Co. license)	雷电战士 (Dream Island Co. license)	Seibu Kaihatsu (Dream Island license)
rdft2	雷电战士 2	雷电战士 2	Seibu Kaihatsu (Tuning license)
rdft2a	雷电战士 2 (亚洲版, Metrotainment license, SPI)	雷电战士 2 (亚洲版, Metrotainment license, SPI)	Seibu Kaihatsu (Metrotainment license)
rdft2a2	雷电战士 2 (亚洲版, Dream Island license, SPI)	雷电战士 2 (亚洲版, Dream Island license, SPI)	Seibu Kaihatsu (Dream Island license)
rdft2j	雷电战士 2 (日版, SPI)	雷电战士 2 (日版, SPI)	Seibu Kaihatsu
rdft2us	雷电战士 2.1 (美版, Single Board)	雷电战士 2.1 (美版, Single Board)	Seibu Kaihatsu (Fabtek license)
rdft22kc	雷电战士 2 - 2000 (中国版)	雷电战士 2 - 2000 (中国版)	Seibu Kaihatsu
rfjet	雷电战士 Jet	雷电战士 Jet	Seibu Kaihatsu (Tuning license)
rfjetu	雷电战士 Jet (美版)	雷电战士 Jet (美版)	Seibu Kaihatsu (Fabtek license)
rfjeta	雷电战士 Jet (亚洲版)	雷电战士 Jet (亚洲版)	Seibu Kaihatsu (Dream Island license)
rfjetj	雷电战士 Jet (日版)	雷电战士 Jet (日版)	Seibu Kaihatsu
rfjetus	雷电战士 Jet (美版, Single Board)	雷电战士 Jet (美版, Single Board)	Seibu Kaihatsu (Fabtek license)
cabal	勇士们 (美版 set 1)	勇士们 (美版 set 1)	Tad (Fabtek license)
cabal2	勇士们 (美版 set 2)	勇士们 (美版 set 2)	Tad (Fabtek license)
cabalbl	勇士们 (盗版)	勇士们 (盗版)	bootleg
toki	人猿 JuJu 传说 / Toki (世界版 set 1)	人猿 JuJu 传说 / Toki (世界版 set 1)	Tad
tokia	人猿 JuJu 传说 / Toki (世界版 set 2)	人猿 JuJu 传说 / Toki (世界版 set 2)	Tad
tokiu	人猿 JuJu 传说 / Toki (美版)	人猿 JuJu 传说 / Toki (美版)	Tad (Fabtek license)
tokib	人猿 JuJu 传说 / Toki (盗版)	人猿 JuJu 传说 / Toki (盗版)	bootleg
juju	人猿 JuJu 传说 (日版)	人猿 JuJu 传说 (日版)	Tad
jujub	人猿 JuJu 传说 (日版, 盗版)	人猿 JuJu 传说 (日版, 盗版)	bootleg
exerion	火凤凰	火凤凰	Jaleco
exeriont	火凤凰 (Taito)	火凤凰 (Taito)	Jaleco (Taito America license)
exerionb	火凤凰 (盗版)	火凤凰 (盗版)	Jaleco
momoko	桃子 120％	桃子 120％	Jaleco
ginganin	银河任侠传 (set 1)	银河任侠传 (set 1)	Jaleco
tetrisp2	俄罗斯方块 Plus 2 (世界版?)	俄罗斯方块 Plus 2 (世界版?)	Jaleco / The Tetris Company
teplus2j	俄罗斯方块 Plus 2 (日版)	俄罗斯方块 Plus 2 (日版)	Jaleco / The Tetris Company
rockn	摇滚舞台 (日版)	摇滚舞台 (日版)	Jaleco
rockna	摇滚舞台 (日版, alternate)	摇滚舞台 (日版, alternate)	Jaleco
rockn2	摇滚舞台 2 (日版)	摇滚舞台 2 (日版)	Jaleco
rocknms	摇滚 MegaSession (日版)	摇滚 MegaSession (日版)	Jaleco
rockn3	摇滚 3 (日版)	摇滚 3 (日版)	Jaleco
rockn4	摇滚 4 (日版, 工程版)	摇滚 4 (日版, 工程版)	Jaleco (PCCWJ)
lomakai	魔魁传说 / Legend of Makai (世界版)	魔魁传说 / Legend of Makai (世界版)	Jaleco
makaiden	魔魁传说 (日版)	魔魁传说 (日版)	Jaleco
p47	P-47 - 幻影战士 (世界版)	P-47 - 幻影战士 (世界版)	Jaleco
p47j	P-47 - 自由战士 (日版)	P-47 - 自由战士 (日版)	Jaleco
tshingen	武田信玄 (日版, 日语)	武田信玄 (日版, 日语)	Jaleco
tshingna	武田信玄 / Shingen Samurai-Fighter (日版, 英语)	武田信玄 / Shingen Samurai-Fighter (日版, 英语)	Jaleco
iganinju	伊贺忍术传 (日版)	伊贺忍术传 (日版)	Jaleco
hachoo	破兆	破兆	Jaleco
jitsupro	实力!! 职业棒球 (日版)	实力!! 职业棒球 (日版)	Jaleco
stdragon	天圣龙	天圣龙	Jaleco
rodland	妖精物语 Rod-land (世界版)	妖精物语 Rod-land (世界版)	Jaleco
rodlandj	妖精物语 Rod-land (日版)	妖精物语 Rod-land (日版)	Jaleco
rodlndjb	妖精物语 Rod-land (日版 盗版)	妖精物语 Rod-land (日版 盗版)	Jaleco
avspirit	复仇精灵	复仇精灵	Jaleco
phantasm	复仇精灵 (日版)	复仇精灵 (日版)	Jaleco
edf	E.D.F.- 地球保卫战	E.D.F.- 地球保卫战	Jaleco
edfu	E.D.F.- 地球保卫战 (北美版)	E.D.F.- 地球保卫战 (北美版)	Jaleco
64street	64 街 (世界版)	64 街 (世界版)	Jaleco
64streej	64 街 (日版)	64 街 (日版)	Jaleco
chimerab	原生兽 (工程版)	原生兽 (工程版)	Jaleco
hayaosi1	早押问答 王座决定战	早押问答 王座决定战	Jaleco
47pie2	偶像雀士 Su-Chi-Pie 2 (v1.1)	偶像雀士 Su-Chi-Pie 2 (v1.1)	Jaleco
47pie2o	偶像雀士 Su-Chi-Pie 2 (v1.0)	偶像雀士 Su-Chi-Pie 2 (v1.0)	Jaleco
desertwr	海湾战争	海湾战争	Jaleco
gametngk	Game 天国 - 枪神!	Game 天国 - 枪神!	Jaleco
tetrisp	俄罗斯方块 Plus	俄罗斯方块 Plus	Jaleco / BPS
p47aces	P-47 - 王牌战士 (世界版)	P-47 - 王牌战士 (世界版)	Jaleco
kirarast	流星雀士 Kirara 之星	流星雀士 Kirara 之星	Jaleco
tp2m32	俄罗斯方块 Plus 2 (MegaSystem 32 Version)	俄罗斯方块 Plus 2 (MegaSystem 32 Version)	Jaleco
rabiolep	兔战士 (日版)	兔战士 (日版)	V-System Co.
rpunch	兔战士 (美版)	兔战士 (美版)	V-System Co. (Bally/Midway/Sente license)
svolley	超级排球 (日版)	超级排球 (日版)	V-System Co.
svolleyk	超级排球 (韩国版)	超级排球 (韩国版)	V-System Co.
svolleyu	超级排球 (美版)	超级排球 (美版)	V-System Co. (Data East license)
tail2nos	超级方程式 - 地面最高速作战 / Tail to Nose - Great Championship	超级方程式 - 地面最高速作战 / Tail to Nose - Great Championship	V-System Co.
sformula	超级方程式 - 地面最高速作战 (日版)	超级方程式 - 地面最高速作战 (日版)	V-System Co.
ojankoc	雀子俱乐部 (日版)	雀子俱乐部 (日版)	V-System Co.
ojankoy	雀子馆 (日版)	雀子馆 (日版)	V-System Co.
ojanko2	雀子馆 2 番馆 (日版)	雀子馆 2 番馆 (日版)	V-System Co.
ccasino	中国乐园 [BET] (日版)	中国乐园 [BET] (日版)	V-System Co.
ojankohs	雀子高中 (日版)	雀子高中 (日版)	V-System Co.
nekkyoku	列岛纵断 热局雀士 - 东日本编 (日版)	列岛纵断 热局雀士 - 东日本编 (日版)	Video System Co.
idolmj	偶像麻雀放送局 (日版)	偶像麻雀放送局 (日版)	System Service
mjnatsu	麻雀夏物语 (日版)	麻雀夏物语 (日版)	Video System Co.
mfunclub	麻雀俱乐部 - 偶像最前线 (日版)	麻雀俱乐部 - 偶像最前线 (日版)	Video System Co.
daiyogen	麻雀大预言 (日版)	麻雀大预言 (日版)	Video System Co.
nmsengen	热血麻雀宣言! AFTER 5 (日版)	热血麻雀宣言! AFTER 5 (日版)	Video System Co.
fromance	偶像麻雀 最终罗曼史 (日版)	偶像麻雀 最终罗曼史 (日版)	Video System Co.
pipedrm	梦幻之笛 (美版)	梦幻之笛 (美版)	Video System Co.
pipedrmj	梦幻之笛 (日版)	梦幻之笛 (日版)	Video System Co.
hatris	带帽人 (日版)	带帽人 (日版)	Video System Co.
pspikes	能量排球 (世界版)	能量排球 (世界版)	Video System Co.
pspikesk	能量排球 (韩国版)	能量排球 (韩国版)	Video System Co.
svolly91	能量排球 '91 (日版)	能量排球 '91 (日版)	Video System Co.
pspikesb	能量排球 (盗版)	能量排球 (盗版)	bootleg
pspikesc	能量排球 (中国)	能量排球 (中国)	bootleg
karatblz	斗神光辉 / 铁腿四少年 (世界版?)	斗神光辉 / 铁腿四少年 (世界版?)	Video System Co.
karatblu	斗神光辉 / 铁腿四少年 (美版)	斗神光辉 / 铁腿四少年 (美版)	Video System Co.
karatblj	斗神光辉 / 铁腿四少年 (日版)	斗神光辉 / 铁腿四少年 (日版)	Video System Co.
turbofrc	超级空军	超级空军	Video System Co.
aerofgt	音速战机 / 四国战机	音速战机 / 四国战机	Video System Co.
aerofgtb	音速战机 / 四国战机 (Turbo Force 硬件 set 1)	音速战机 / 四国战机 (Turbo Force 硬件 set 1)	Video System Co.
aerofgtc	音速战机 / 四国战机 (Turbo Force 硬件 set 2)	音速战机 / 四国战机 (Turbo Force 硬件 set 2)	Video System Co.
sonicwi	音速之翼 / 四国战机 (日版)	音速之翼 / 四国战机 (日版)	Video System Co.
aerfboot	音速战机 / 四国战机 (盗版)	音速战机 / 四国战机 (盗版)	bootleg
crshrace	爆裂 Crash Race (set 1)	爆裂 Crash Race (set 1)	Video System Co.
crshrac2	爆裂 Crash Race (set 2)	爆裂 Crash Race (set 2)	Video System Co.
suprslam	灌篮高手 / 篮球飞人	灌篮高手 / 篮球飞人	Banpresto / Toei Animation
fromanc2	对战偶像麻雀 最终罗曼史 2 (日版)	对战偶像麻雀 最终罗曼史 2 (日版)	Video System Co.
fromancr	对战麻雀 最终罗曼史 R (日版)	对战麻雀 最终罗曼史 R (日版)	Video System Co.
fromanc4	对战麻雀 最终罗曼史 4 (日版)	对战麻雀 最终罗曼史 4 (日版)	Video System Co.
samuraia	战国 Ace (世界版)	战国 Ace (世界版)	Psikyo
sngkace	战国 Ace (日版)	战国 Ace (日版)	Psikyo
gunbird	武装飞鸟 (世界版)	武装飞鸟 (世界版)	Psikyo
gunbirdk	武装飞鸟 (韩国版)	武装飞鸟 (韩国版)	Psikyo
gunbirdj	武装飞鸟 (日版)	武装飞鸟 (日版)	Psikyo
s1945	打击者 1945	打击者 1945	Psikyo
s1945a	打击者 1945 (Alt)	打击者 1945 (Alt)	Psikyo
s1945j	打击者 1945 (日版)	打击者 1945 (日版)	Psikyo
s1945jn	打击者 1945 (日版, unprotected)	打击者 1945 (日版, unprotected)	Psikyo
s1945k	打击者 1945 (韩国版)	打击者 1945 (韩国版)	Psikyo
tengai	战国之刃 / Tengai: 战国 Ace 第二幕	战国之刃 / Tengai: 战国 Ace 第二幕	Psikyo
s1945ii	打击者 1945 II	打击者 1945 II	Psikyo
soldivid	太阳表决 - 暗黑之剑	太阳表决 - 暗黑之剑	Psikyo
sbomberb	太空炸弹人 (ver. B)	太空炸弹人 (ver. B)	Psikyo
daraku	堕落天使	堕落天使	Psikyo
dragnblz	龙之怒火	龙之怒火	Psikyo
gunbird2	武装飞鸟 2	武装飞鸟 2	Psikyo
s1945iii	打击者 1945 III (世界版) / 打击者 1999 (日版)	打击者 1945 III (世界版) / 打击者 1999 (日版)	Psikyo
mjgtaste	麻将 G-味道	麻将 G-味道	Psikyo
hotgmck	对战 狂热的秘密装置 (日版)	对战 狂热的秘密装置 (日版)	Psikyo
hgkairak	对战 狂热的秘密装置 快乐天 (日版)	对战 狂热的秘密装置 快乐天 (日版)	Psikyo
hotgmck3	对战 狂热的秘密装置 3 - 数字冲浪 (日版)	对战 狂热的秘密装置 3 - 数字冲浪 (日版)	Psikyo
hotgm4ev	对战 狂热的秘密装置 4 曾经 (日版)	对战 狂热的秘密装置 4 曾经 (日版)	Psikyo
hotgmcki	对战 狂热的秘密装置 整体 (日版)	对战 狂热的秘密装置 整体 (日版)	Psikyo
loderndf	淘金者 - 考古之战 (ver. B) (日版)	淘金者 - 考古之战 (ver. B) (日版)	Psikyo
loderdfa	淘金者 - 考古之战 (ver. A) (日版)	淘金者 - 考古之战 (ver. A) (日版)	Psikyo
hotdebut	偶像问答! Hot Debut (日版)	偶像问答! Hot Debut (日版)	Psikyo / Moss
xorworld	异域表世界 (工程版)	异域表世界 (工程版)	Gaelco
biomtoy	生化玩具兵 (unprotected)	生化玩具兵 (unprotected)	Gaelco
airbustr	空中堡垒 (世界版)	空中堡垒 (世界版)	Kaneko (Namco license)
airbustj	空中堡垒 (日版)	空中堡垒 (日版)	Kaneko (Namco license)
airbusb	空中堡垒 (盗版)	空中堡垒 (盗版)	bootleg
galpanic	天蚕变 (set 1)	天蚕变 (set 1)	Kaneko
galpanib	天蚕变 (set 2)	天蚕变 (set 2)	Kaneko
galpania	天蚕变 (set 3)	天蚕变 (set 3)	Kaneko
galpani2	天蚕变 II (日版?)	天蚕变 II (日版?)	Kaneko
galpan2g	天蚕变 II (德国版)	天蚕变 II (德国版)	Kaneko
galpan2t	天蚕变 II (Taiwan)	天蚕变 II (Taiwan)	Kaneko
galpan2j	天蚕变 II (日版)	天蚕变 II (日版)	Kaneko
gp2quiz	天蚕变 II - Quiz Version (日版)	天蚕变 II - Quiz Version (日版)	Kaneko
gp2se	天蚕变 II' - Special Edition (日版)	天蚕变 II' - Special Edition (日版)	Kaneko
galpani3	天蚕变 3	天蚕变 3	Kaneko
berlwall	柏林墙	柏林墙	Kaneko
berlwalt	柏林墙 (盗版 ?)	柏林墙 (盗版 ?)	Kaneko
mgcrystl	魔法水晶 (世界版, 92/01/10)	魔法水晶 (世界版, 92/01/10)	Kaneko
mgcrysto	魔法水晶 (世界版, 91/12/10)	魔法水晶 (世界版, 91/12/10)	Kaneko
mgcrystj	魔法水晶 (日版, 92/01/13)	魔法水晶 (日版, 92/01/13)	Kaneko (Atlus license)
blazeon	魂之光辉 (日版)	魂之光辉 (日版)	Atlus
sandscrp	沙漠之蝎 (set 1)	沙漠之蝎 (set 1)	Face
sandscra	沙漠之蝎 (set 2)	沙漠之蝎 (set 2)	Face
galpani4	天蚕变 4 (日版)	天蚕变 4 (日版)	Kaneko
galpanis	天蚕变 S - 特别版 (日版)	天蚕变 S - 特别版 (日版)	Kaneko
sengekis	闪激 Striker (亚洲版)	闪激 Striker (亚洲版)	Kaneko / Warashi
sengekij	闪激 Striker (日版)	闪激 Striker (日版)	Kaneko / Warashi
galpans2	天蚕变 S2 (日版)	天蚕变 S2 (日版)	Kaneko
panicstr	罪恶之街 (日版)	罪恶之街 (日版)	Kaneko
senknow	线脑 (日版)	线脑 (日版)	Kaneko / Kouyousha
gutsn	Guts'n (日版)	Guts'n (日版)	Kaneko / Kouyousha
puzzloop	环绕球 (欧洲版)	环绕球 (欧洲版)	Mitchell
puzloopj	环绕球 (日版)	环绕球 (日版)	Mitchell
puzloopk	环绕球 (韩国版)	环绕球 (韩国版)	Mitchell
puzloopu	环绕球 (美版)	环绕球 (美版)	Mitchell
ryouran	VS麻雀 乙女缭乱	VS麻雀 乙女缭乱	Electro Design
teljan	Tel 雀	Tel 雀	Electro Design
hanaawas	花札 (Flower Matching)	花札 (Flower Matching)	Seta
srmp2	超写真麻雀 Part 2 (日版)	超写真麻雀 Part 2 (日版)	Seta
srmp3	超写真麻雀 Part 3 (日版)	超写真麻雀 Part 3 (日版)	Seta
mjyuugi	麻雀游技 (日版 set 1)	麻雀游技 (日版 set 1)	Visco
mjyuugia	麻雀游技 (日版 set 2)	麻雀游技 (日版 set 2)	Visco
ponchin	麻雀 碰吃杠 (日版 set 1)	麻雀 碰吃杠 (日版 set 1)	Visco
ponchina	麻雀 碰吃杠 (日版 set 2)	麻雀 碰吃杠 (日版 set 2)	Visco
tndrcade	特殊部队 UAG　/ Thundercade	特殊部队 UAG　/ Thundercade	[Seta] (Taito license)
tndrcadj	特殊部队 UAG (日版)	特殊部队 UAG (日版)	[Seta] (Taito license)
twineagl	双鹰 (日版)	双鹰 (日版)	Seta (Taito license)
downtown	目击 (Set 1)	目击 (Set 1)	Seta
calibr50	点五零	点五零	Athena / Seta
metafox	沙漠之狐	沙漠之狐	Seta
qzkklogy	心理问答	心理问答	Tecmo
umanclub	咸蛋超人俱乐部 - 战斗! 奥特曼兄弟!!	咸蛋超人俱乐部 - 战斗! 奥特曼兄弟!!	Tsuburaya Prod. / Banpresto
zingzip	真真急炮	真真急炮	Allumer + Tecmo
kamenrid	假面骑士俱乐部	假面骑士俱乐部	Toei / Banpresto
msgundam	机动战士高达	机动战士高达	Banpresto
msgunda1	机动战士高达 (日版)	机动战士高达 (日版)	Banpresto
daioh	大王	大王	Athena
utoukond	奥特曼斗魂传说 (日本版)	奥特曼斗魂传说 (日本版)	Banpresto + Tsuburaya Prod.
qzkklgy2	心理问答 2	心理问答 2	Tecmo
wrofaero	空战 - MEIOU 计划	空战 - MEIOU 计划	Yang Cheng
kiwame	职业麻雀 极	职业麻雀 极	Athena
extdwnhl	极限滑降 (v1.5)	极限滑降 (v1.5)	Sammy Industries Japan
gundhara	铳弹岚	铳弹岚	Banpresto
sokonuke	Sokonuke 对战游戏 (日版)	Sokonuke 对战游戏 (日版)	Sammy Industries
grdians	电神魔傀 II / 守护将军	电神魔傀 II / 守护将军	Banpresto
mj4simai	若草物语 麻雀四姊妹 (日版)	若草物语 麻雀四姊妹 (日版)	Maboroshi Ware
myangel	育婴问答 - 亲亲小宝贝 (日版)	育婴问答 - 亲亲小宝贝 (日版)	Namco
myangel2	育婴问答 - 亲亲小宝贝 2 (日版)	育婴问答 - 亲亲小宝贝 2 (日版)	Namco
srmp4	超写真麻雀 PIV (日版)	超写真麻雀 PIV (日版)	Seta
srmp4o	超写真麻雀 PIV (日版, older set)	超写真麻雀 PIV (日版, older set)	Seta
twineag2	双鹰 2 - The Rescue Mission	双鹰 2 - The Rescue Mission	Seta
srmp7	超写真麻雀 P7 (日版)	超写真麻雀 P7 (日版)	Seta
survarts	死亡艺术 (世界版)	死亡艺术 (世界版)	Sammy
survartu	死亡艺术 (美版)	死亡艺术 (美版)	Sammy (American)
hypreact	麻雀 Hyper Reaction (日版)	麻雀 Hyper Reaction (日版)	Sammy
hypreac2	麻雀 Hyper Reaction 2 (日版)	麻雀 Hyper Reaction 2 (日版)	Sammy
sxyreact	绝色柏青哥 (日版)	绝色柏青哥 (日版)	Sammy
sxyreac2	绝色柏青哥 2 (日版)	绝色柏青哥 2 (日版)	Sammy
janjans1	超可爱麻雀 (日版)	超可爱麻雀 (日版)	Visco
koikois2	超级 Real 花札 恋恋 2 (日版)	超级 Real 花札 恋恋 2 (日版)	Visco
ryorioh	问答 美食料理王 CooKing (日版)	问答 美食料理王 CooKing (日版)	Visco
vasara	婆裟罗	婆裟罗	Visco
vasara2	婆裟罗 2(set 1)	婆裟罗 2(set 1)	Visco
vasara2a	婆裟罗 2(set 2)	婆裟罗 2(set 2)	Visco
powerins	豪血寺一族 (日版)	豪血寺一族 (日版)	Atlus
powerina	豪血寺一族 (美版, 盗版 set 1)	豪血寺一族 (美版, 盗版 set 1)	Atlus
powerinb	豪血寺一族 (美版, 盗版 set 2)	豪血寺一族 (美版, 盗版 set 2)	Atlus
powernjb	豪血寺一族 (日版, 盗版)	豪血寺一族 (日版, 盗版)	Atlus
blmbycar	Blomby 赛车	Blomby 赛车	ABM & Gecas
blmbycau	Blomby 赛车 (未加密)	Blomby 赛车 (未加密)	ABM & Gecas
ttmahjng	T.T.麻雀	T.T.麻雀	Taito
kangaroo	袋鼠	袋鼠	Sun Electronics
strnskil	锯木王 - 力技合一	锯木王 - 力技合一	Sun Electronics
guiness	锯木王 (日版)	锯木王 (日版)	Sun Electronics
shanghai	上海	上海	Sunsoft
shangha2	上海 II (日版)	上海 II (日版)	Sunsoft
shangha3	上海 III (日版)	上海 III (日版)	Sunsoft
bssoccer	街头足球	街头足球	SunA
uballoon	终极打气球	终极打气球	SunA
gundealr	美女枪手 (set 1)	美女枪手 (set 1)	Dooyong
gundeala	美女枪手 (set 2)	美女枪手 (set 2)	Dooyong
gundealt	美女枪手 (Tecmo)	美女枪手 (Tecmo)	Tecmo
lastday	末日危机 (set 1)	末日危机 (set 1)	Dooyong
lastdaya	末日危机 (set 2)	末日危机 (set 2)	Dooyong
gulfstrm	海湾风暴	海湾风暴	Dooyong
gulfstr2	海湾风暴 (Media 商事)	海湾风暴 (Media 商事)	Dooyong (Media Shoji license)
pollux	双子座之星 (set 1)	双子座之星 (set 1)	Dooyong
polluxa	双子座之星 (set 2)	双子座之星 (set 2)	Dooyong
polluxa2	双子座之星 (set 3)	双子座之星 (set 3)	Dooyong
bluehawk	鹰击蓝空	鹰击蓝空	Dooyong
bluehawn	鹰击蓝空 (NTC)	鹰击蓝空 (NTC)	[Dooyong] (NTC license)
rshark	R - 鲛	R - 鲛	Dooyong
galspnbl	少女弹珠台	少女弹珠台	Comad
wbeachvl	世界沙滩排球 (set 1)	世界沙滩排球 (set 1)	Playmark
wbeachv2	世界沙滩排球 (set 2)	世界沙滩排球 (set 2)	Playmark
natodef	北约防线	北约防线	Pacific Novelty
natodefa	北约防线 (alternate mazes)	北约防线 (alternate mazes)	Pacific Novelty
crzrally	疯狂拉力 (set 1)	疯狂拉力 (set 1)	Tecfri
karatour	空手道大赛	空手道大赛	Mitchell
ladykill	燃烧吧 Gonta!! (日版)	燃烧吧 Gonta!! (日版)	Yanyaka (Mitchell license)
moegonta	燃烧吧 Gonta!! (日版)	燃烧吧 Gonta!! (日版)	Yanyaka
pangpoms	魔法气泡	魔法气泡	Metro
pangpomm	魔法气泡 (Mitchell)	魔法气泡 (Mitchell)	Metro (Mitchell license)
dharma	达摩道场	达摩道场	Metro
dharmak	达摩道场 (韩国版)	达摩道场 (韩国版)	Metro
lastfort	牌砦	牌砦	Metro
lastfero	牌砦 (Erotic)	牌砦 (Erotic)	Metro
toride2g	牌砦 II 复仇外传 / 战国智慧牌	牌砦 II 复仇外传 / 战国智慧牌	Metro
torid2gg	牌砦 II 复仇外传 (德国版)	牌砦 II 复仇外传 (德国版)	Metro
daitorid	大牌砦	大牌砦	Metro
dokyusei	麻雀 同级生	麻雀 同级生	Make Software / Elf / Media Trading
dokyusp	麻雀 同级生 特别版	麻雀 同级生 特别版	Make Software / Elf / Media Trading
3kokushi	三刻志 (日版)	三刻志 (日版)	Mitchell
gakusai	麻雀学园祭 (日版)	麻雀学园祭 (日版)	MakeSoft
gakusai2	麻雀学园祭 2 (日版)	麻雀学园祭 2 (日版)	MakeSoft
spcforce	太空武力	太空武力	Venture Line
spcforc2	太空武力 (set 2)	太空武力 (set 2)	Elcon (bootleg?)
pbancho	逆转!! Puzzle 番长 (日版)	逆转!! Puzzle 番长 (日版)	Fuuki
burglarx	夜盗 X	夜盗 X	Unico
silkroad	丝绸之路	丝绸之路	Unico
grdnstrm	战神 守护风暴 (韩国版)	战神 守护风暴 (韩国版)	Afega
bubl2000	泡泡野人版	泡泡野人版	Tuning
royalmah	皇家麻雀 (日版)	皇家麻雀 (日版)	Falcon
hnayayoi	华弥生 (日版)	华弥生 (日版)	Dyna Electronics
dondenmj	Don Den 麻雀 [BET] (日版)	Don Den 麻雀 [BET] (日版)	Dyna Electronics
hnfubuki	华吹雪 [BET] (日版)	华吹雪 [BET] (日版)	Dynax
mjdiplob	麻雀 Diplomat [BET] (日版)	麻雀 Diplomat [BET] (日版)	Dynax
tontonb	东东 [BET] (日版)	东东 [BET] (日版)	Dynax
hanamai	华之舞 (日版)	华之舞 (日版)	Dynax
majs101b	麻雀工作室 101 [BET] (日版)	麻雀工作室 101 [BET] (日版)	Dynax
hnkochou	华蝴蝶 [BET] (日版)	华蝴蝶 [BET] (日版)	Dynax
mjfriday	麻雀星期五 (日版)	麻雀星期五 (日版)	Dynax
mjdialq2	麻雀拨号盘 Q2 (日版)	麻雀拨号盘 Q2 (日版)	Dynax
quizchq	问题 民国教育委员会 (Ver 1.00) (日版)	问题 民国教育委员会 (Ver 1.00) (日版)	Nakanihon
quizchql	问题 民国教育委员会 (Ver 1.23) (台湾版?)	问题 民国教育委员会 (Ver 1.23) (台湾版?)	Nakanihon (Laxan license)
quiz365	问答 365 (日版)	问答 365 (日版)	Nakanihon
quiz365t	问答 365 (香港版 & 台湾版)	问答 365 (香港版 & 台湾版)	Nakanihon + Taito
rongrong	龙龙 (欧洲版)	龙龙 (欧洲版)	Nakanihon
rongrngg	龙龙 (德语版)	龙龙 (德语版)	Nakanihon
ddenlovr	决战于黑白之间 Vol.1 (香港版)	决战于黑白之间 Vol.1 (香港版)	Dynax
mjchuuka	麻雀 中华儿女 (中国版)	麻雀 中华儿女 (中国版)	Dynax
nyny	拯救纽约	拯救纽约	Sigma Enterprises Inc.
nynyg	拯救纽约 (Gottlieb)	拯救纽约 (Gottlieb)	Sigma Enterprises Inc. (Gottlieb license)
arcadia	拯救纽约 / 青春世外桃源	拯救纽约 / 青春世外桃源	Sigma Enterprises Inc.
chindrag	中国龙 (日版, V021J)	中国龙 (日版, V021J)	IGS / ALTA
chugokur	中国龙 (日版, V020J)	中国龙 (日版, V020J)	IGS / ALTA
chmplst2	龙虎榜 II	龙虎榜 II	IGS
lhb	龙虎榜	龙虎榜	IGS
xymg	幸运满灌 (V651C)	幸运满灌 (V651C)	IGS
grtwall	万里长城 (V638C)	万里长城 (V638C)	IGS
vbowl	虚拟保龄球 (世界版, V101XCM)	虚拟保龄球 (世界版, V101XCM)	Alta / IGS
vbowlj	虚拟保龄球 (日版, V100JCM)	虚拟保龄球 (日版, V100JCM)	Alta / IGS
drgnwrld	中国龙 (世界版, V0400)	中国龙 (世界版, V0400)	IGS
drgwrld3	中国龙 (世界版, V0300)	中国龙 (世界版, V0300)	IGS
hfh	黄飞鸿	黄飞鸿	IGS
orlegend	西游释厄传 (ver. 126)	西游释厄传 (ver. 126)	IGS
orlegnde	西游释厄传 (ver. 112)	西游释厄传 (ver. 112)	IGS
orlegndc	西游释厄传 (ver. 112, 中文基板)	西游释厄传 (ver. 112, 中文基板)	IGS
orld111c	西游释厄传 (ver. 111, 中文基板)	西游释厄传 (ver. 111, 中文基板)	IGS
orld105k	西游释厄传 (ver. 105, 韩文基板)	西游释厄传 (ver. 105, 韩文基板)	IGS
drgw2	中国龙 II (ver. 110X, 输出版)	中国龙 II (ver. 110X, 输出版)	IGS
drgw2c	中国龙 II (ver. 100C, 中国版)	中国龙 II (ver. 100C, 中国版)	IGS
drgw2j	中国龙 II (ver. 100J, 日版)	中国龙 II (ver. 100J, 日版)	IGS
drgw3	中国龙 III	中国龙 III	IGS
drgw3k	中国龙 III (韩文机板)	中国龙 III (韩文机板)	IGS
kov	三国战纪 (ver. 117)	三国战纪 (ver. 117)	IGS
kovplus	三国战纪 Plus (ver. 119)	三国战纪 Plus (ver. 119)	IGS
kovplusa	三国战纪 Plus (alt ver. 119)	三国战纪 Plus (alt ver. 119)	IGS
kov115	三国战纪 (ver. 115)	三国战纪 (ver. 115)	IGS
kovj	三国战纪 (ver. 100, 日本语 Board)	三国战纪 (ver. 100, 日本语 Board)	IGS
kovsh	三国战纪 - 风云再起 (ver. 322)	三国战纪 - 风云再起 (ver. 322)	IGS
photoy2k	大家来找茬	大家来找茬	IGS
raf102j	真与假 / 大家来找茬 (ver. 102, 日版 Board)	真与假 / 大家来找茬 (ver. 102, 日版 Board)	IGS
killbld	傲剑狂刀	傲剑狂刀	IGS
killbldt	傲剑狂刀 (台湾版?)	傲剑狂刀 (台湾版?)	IGS
puzlstar	魔幻星座	魔幻星座	IGS
olds	西游释厄传 Super (韩国版 101)	西游释厄传 Super (韩国版 101)	IGS
olds100	西游释厄传 Super (100)	西游释厄传 Super (100)	IGS
olds100a	西游释厄传 Super (100 alt)	西游释厄传 Super (100 alt)	IGS
kov2	三国战纪 2	三国战纪 2	IGS
kov2106	三国战纪 2 (106)	三国战纪 2 (106)	IGS
kov2p	三国战纪 2 Plus - 飞龙在天	三国战纪 2 Plus - 飞龙在天	IGS
ddp2	蜂暴 - 怒首领蜂 2	蜂暴 - 怒首领蜂 2	IGS
puzzli2	魔幻星座 2 超级	魔幻星座 2 超级	IGS
martmast	形意拳	形意拳	IGS
mjkjidai	麻雀狂时代 (日版)	麻雀狂时代 (日版)	Sanritsu
mayumi	千钧一发 真由美	千钧一发 真由美	[Sanritsu] Victory L.L.C.
btoads	忍者蛙	忍者蛙	Rare
kinst	杀手学堂 (v1.5d)	杀手学堂 (v1.5d)	Rare
kinst14	杀手学堂 (v1.4)	杀手学堂 (v1.4)	Rare
kinst13	杀手学堂 (v1.3)	杀手学堂 (v1.3)	Rare
kinstp	杀手学堂 (proto v4.7)	杀手学堂 (proto v4.7)	Rare
kinst2	杀手学堂 2 (v1.4)	杀手学堂 2 (v1.4)	Rare
kinst2k	杀手学堂 2 (v1.4k, upgrade kit)	杀手学堂 2 (v1.4k, upgrade kit)	Rare
kinst213	杀手学堂 2 (v1.3)	杀手学堂 2 (v1.3)	Rare
kinst211	杀手学堂 2 (v1.1)	杀手学堂 2 (v1.1)	Rare
kinst210	杀手学堂 2 (v1.0)	杀手学堂 2 (v1.0)	Rare
rmhaihai	Real 麻雀牌牌 (日版)	Real 麻雀牌牌 (日版)	Alba
rmhaihib	Real 麻雀牌牌 [BET] (日版)	Real 麻雀牌牌 [BET] (日版)	Alba
rmhaijin	Real 麻雀牌牌 - 人事异动编 (日版)	Real 麻雀牌牌 - 人事异动编 (日版)	Alba
rmhaisei	Real 麻雀牌牌 - 成长编 (日版)	Real 麻雀牌牌 - 成长编 (日版)	Visco
themj	The 麻雀 (日版)	The 麻雀 (日版)	Visco
hanaroku	花六	花六	Alba
hourouki	麻雀放浪记 Part 1 - 青春编 (日版)	麻雀放浪记 Part 1 - 青春编 (日版)	Home Data
mhgaiden	麻雀放浪记外传 (日版)	麻雀放浪记外传 (日版)	Home Data
mjhokite	麻雀放浪记  (日版)	麻雀放浪记  (日版)	Home Data
mjclinic	麻雀诊所 (日版)	麻雀诊所 (日版)	Home Data
mrokumei	麻雀鹿鸣馆 (日版)	麻雀鹿鸣馆 (日版)	Home Data
reikaids	灵界道士 (日版)	灵界道士 (日版)	Home Data
mjkojink	麻雀 个人教授 (Private Teacher)(日版)	麻雀 个人教授 (Private Teacher)(日版)	Home Data
vitaminc	麻雀 维他命 C (日版)	麻雀 维他命 C (日版)	Home Data
mjyougo	麻雀用语之基础体力 (日版)	麻雀用语之基础体力 (日版)	Home Data
lemnangl	麻雀柠檬天使 (日版)	麻雀柠檬天使 (日版)	Home Data
mjkinjas	麻雀 禁游戏 - 教师的欲望 (日版)	麻雀 禁游戏 - 教师的欲望 (日版)	Home Data
battlcry	Battlecry	Battlecry	Home Data
jogakuen	麻雀女学园 (日版)	麻雀女学园 (日版)	Windom
mjikaga	麻雀 Ikagadesuka (日版)	麻雀 Ikagadesuka (日版)	Mitchell
chinhero	中华英雄	中华英雄	Taiyo
chinher2	中华英雄 (older)	中华英雄 (older)	Taiyo
chinhert	中华英雄 (Taito)	中华英雄 (Taito)	Taito
shangkid	飞龙之拳 / 上海小子	飞龙之拳 / 上海小子	Taiyo (Data East license)
hiryuken	北派少林 飞龙之拳	北派少林 飞龙之拳	[Nihon Game] (Taito license)
stlforce	钢铁力量	钢铁力量	Electronic Devices Italy / Ecogames S.L. Spain
spaceint	宇宙侵略者	宇宙侵略者	Shoei
exterm	灭杀者	灭杀者	Gottlieb / Premier Technology
othldrby	赛马会 (日版)	赛马会 (日版)	Sunwise
sprcros2	超级大十字 2 (日版 set 1)	超级大十字 2 (日版 set 1)	GM Shoji
sprcrs2a	超级大十字 2 (日版 set 2)	超级大十字 2 (日版 set 2)	GM Shoji
gcpinbal	大十字弹珠台	大十字弹珠台	Excellent System
aquarium	海底生物战 (日版)	海底生物战 (日版)	Excellent System
sshooter	神枪手 (Rev 1.7)	神枪手 (Rev 1.7)	P & P Marketing
sshoot12	神枪手 (Rev 1.2)	神枪手 (Rev 1.2)	P & P Marketing
sshoot11	神枪手 (Rev 1.1)	神枪手 (Rev 1.1)	P & P Marketing
oneshot	百发百中	百发百中	<unknown>
pipeline	水管工	水管工	Daehyun Electronics
tetriunk	俄罗斯方块 (Unknown Manufacturer)	俄罗斯方块 (Unknown Manufacturer)	Unknown
knightsh	圆桌骑士 (hack)	圆桌骑士 (hack)	hack / bootleg
knightsb	圆桌骑士 (盗版)	圆桌骑士 (盗版)	bootleg
sf2m8	街头霸王 II - 四大天王 (M8)	街头霸王 II - 四大天王 (M8)	hack / bootleg
sf2m13	街头霸王 II - 四大天王 (M13)	街头霸王 II - 四大天王 (M13)	hack / bootleg
sf2tlona	屠龙 (set 1)	屠龙 (set 1)	hack / bootleg
sf2tlonb	屠龙 (set 2)	屠龙 (set 2)	hack / bootleg
wofb	吞食天地 II 赤壁之战 (盗版)	吞食天地 II 赤壁之战 (盗版)	bootleg
wofsj	圣剑三国 (set 1)	圣剑三国 (set 1)	hack / bootleg
wofsja	圣剑三国 (set 2)	圣剑三国 (set 2)	hack / bootleg
wofsjb	圣剑三国 (set 3)	圣剑三国 (set 3)	hack / bootleg
wof3js	三剑圣	三剑圣	hack / bootleg
wof3sj	三圣剑 (set 1)	三圣剑 (set 1)	hack / bootleg
wof3sja	三圣剑 (set 2)	三圣剑 (set 2)	hack / bootleg
wofh	三国英雄传 (set 1)	三国英雄传 (set 1)	hack / bootleg
wofha	三国英雄传 (set 2)	三国英雄传 (set 2)	hack / bootleg
dinob	恐龙时代 / 凯迪拉克 - 恐龙新世纪 (盗版)	恐龙时代 / 凯迪拉克 - 恐龙新世纪 (盗版)	bootleg
dinoh	恐龙时代 / 凯迪拉克 - 恐龙新世纪 (hack)	恐龙时代 / 凯迪拉克 - 恐龙新世纪 (hack)	hack / bootleg
dinoha	恐龙时代 / 凯迪拉克 - 恐龙新世纪 (盗版, set 1)	恐龙时代 / 凯迪拉克 - 恐龙新世纪 (盗版, set 1)	hack / bootleg
dinohb	恐龙时代 / 凯迪拉克 - 恐龙新世纪 (盗版, set 2)	恐龙时代 / 凯迪拉克 - 恐龙新世纪 (盗版, set 2)	hack / bootleg
sfzch	少年街霸 (CPS Changer 日版 951020)	少年街霸 (CPS Changer 日版 951020)	Capcom
sfach	少年街霸 阿尔法 (Publicity 美版 950727)	少年街霸 阿尔法 (Publicity 美版 950727)	Capcom
ddtodd	龙与地下城: 毁灭之塔 (欧版 940412 凤凰版)	龙与地下城: 毁灭之塔 (欧版 940412 凤凰版)	hack
avspd	异形 对 铁血战士 (欧版 940520 凤凰版)	异形 对 铁血战士 (欧版 940520 凤凰版)	hack
ringdstd	摔角霸王 II (欧版 940902 凤凰版)	摔角霸王 II (欧版 940902 凤凰版)	hack
xmcotad	X-战警: 磁场原子人 (欧版 950105 凤凰版)	X-战警: 磁场原子人 (欧版 950105 凤凰版)	hack
nwarrud	午夜战士: 恶魔的复仇 (美版 950406 凤凰版)	午夜战士: 恶魔的复仇 (美版 950406 凤凰版)	hack
sfad	少年街霸 阿尔法: 斗士之梦 (欧版 950727 凤凰版)	少年街霸 阿尔法: 斗士之梦 (欧版 950727 凤凰版)	hack
19xxd	19XX: 命运否决战 (美版 951207 凤凰版)	19XX: 命运否决战 (美版 951207 凤凰版)	hack
ddsomud	龙与地下城 2: 暗黑秘影 (美版 960619 凤凰版)	龙与地下城 2: 暗黑秘影 (美版 960619 凤凰版)	hack
spf2xjd	超级方块战士 2 X (日版 960531 凤凰版)	超级方块战士 2 X (日版 960531 凤凰版)	hack
megamn2d	洛克人 2: 力量勇士 (美版 960708 凤凰版)	洛克人 2: 力量勇士 (美版 960708 凤凰版)	hack
sfz2aad	少年街霸 零 2 阿尔法 (亚洲版 960826 凤凰版)	少年街霸 2 阿尔法 (亚洲版 960826 凤凰版)	hack
xmvsfu1d	X-战警 对 街霸 (美版 961004 凤凰版)	X-战警 对 街霸 (美版 961004 凤凰版)	hack
batcird	战斗回路 (欧版 970319 凤凰版)	战斗回路 (欧版 970319 凤凰版)	hack
vsavd	吸血鬼救世主: 恶魔的上帝 (欧版 970519 凤凰版)	吸血鬼救世主: 恶魔的上帝 (欧版 970519 凤凰版)	hack
mvscud	漫画英雄 对 Capcom: 超级英雄的冲突 (美版 980123 凤凰版)	漫画英雄 对 Capcom: 超级英雄的冲突 (美版 980123 凤凰版)	hack
sfa3d	少年街霸 阿尔法 3 (美版 980904 凤凰版)	少年街霸 阿尔法 3 (美版 980904 凤凰版)	hack
gwingjd	千兆翼 (日版 990223 凤凰版)	千兆翼 (日版 990223 凤凰版)	hack
1944d	1944: 环岛之战 (美版 000620 凤凰版)	1944: 环岛之战 (美版 000620 凤凰版)	hack
hsf2d	超级街霸 2：周年纪念版 (亚洲版 040202 凤凰版)	超级街霸 2：周年纪念版 (亚洲版 040202 凤凰版)	hack
dstlku1d	恶魔战士: 午夜斗士 (美版 940705 凤凰版)	恶魔战士: 午夜斗士 (美版 940705 凤凰版)	hack
kof96ep	拳皇 '96 (盗版)	拳皇 '96 (盗版)	bootleg
kof97pla	拳皇 '97 重出江湖 加强版 2003 (盗版)	拳皇 '97 重出江湖 加强版 2003 (盗版)	bootleg
kf2k1pls	拳皇 2001 增强型加强版 (set 1, 盗版)	拳皇 2001 增强型加强版 (set 1, 盗版)	bootleg
kf2k1pa	拳皇 2001 风云再起加强版 (set 2, 盗版)	拳皇 2001 风云再起加强版 (set 2, 盗版)	bootleg
cthd2k3a	卧虎藏龙 2003 (set 2)	卧虎藏龙 2003 (set 2)	bootleg
kof2002b	拳皇 2002 - 终极挑战 (盗版)	拳皇 2002 - 终极挑战 (盗版)	bootleg
kf2k2plb	拳皇 2002 - 终极挑战 加强版 (set 3, 盗版)	拳皇 2002 - 终极挑战 加强版 (set 3, 盗版)	bootleg
kf2k2plc	拳皇 2002 - 终极挑战 超级 (set 4, 盗版)	拳皇 2002 - 终极挑战 超级 (set 4, 盗版)	bootleg
kf2k4pls	拳皇 特别版 2004 加强版 (盗版)	拳皇 特别版 2004 加强版 (盗版)	bootleg
matrimbl	斗婚 / 新豪血寺一族 (盗版)	斗婚 / 新豪血寺一族 (盗版)	bootleg
mslug5b	合金弹头 5 (盗版)	合金弹头 5 (盗版)	bootleg
zintrkcd	生物泡泡 (CD转MVS版)	生物泡泡 (CD转MVS版)	hack
fr2ch	对战偶像麻雀 最终罗曼史 2 (CD转MVS版)	对战偶像麻雀 最终罗曼史 2 (CD转MVS版)	hack
vantris	Vantris (Vanguard hardware)	Vantris (Vanguard hardware)	N.Kehrer
frogfest	青蛙盛宴	青蛙盛宴	Rastersoft
columnsn	形体方块 (Neo-Geo)	形体方块 (Neo-Geo)	Sega / hack
poknight	扑克之夜	扑克之夜	JMK
neodemo	Neo-演示	Neo-演示	Chaos
neo2500	Neo 2500 演示	Neo 2500 演示	Blastar
syscheck	Neo 系统检测 (ver 1.0b)	Neo 系统检测 (ver 1.0b)	Blastar
neonopon	Neo 魔法宝石 (beta)	Neo 魔法宝石 (beta)	Blastar
neopong	Neo 碰碰球 (v1.1)	Neo 碰碰球 (v1.1)	Neodev
npong10	Neo 碰碰球 (v1.0)	Neo 碰碰球 (v1.0)	Neodev
zupapad	星星大作战! (特殊解密 C)	星星大作战! (特殊解密 C)	SNK
kof99d	拳皇 '99 - 千年之战 (解密 C)	拳皇 '99 - 千年之战 (解密 C)	SNK
ganryud	武藏严流记 / 武藏传说 (解密 C)	武藏严流记 / 武藏传说 (解密 C)	Visco
garoud	饿狼 - 群狼之证 / 狼之烙印 (解密 C)	饿狼 - 群狼之证 / 狼之烙印 (解密 C)	SNK
s1945pd	打击者 1945 加强版 (解密 C)	打击者 1945 加强版 (解密 C)	Psikyo
preisl2d	原始岛 2 (解密 C)	原始岛 2 (解密 C)	Yumekobo
mslug3d	合金弹头 3 (解密 C)	合金弹头 3 (解密 C)	SNK
kof2000d	拳皇 2000 (解密 C)	拳皇 2000 (解密 C)	SNK
nitdd	黑暗守墓者 / 暗黑恶梦 (解密 C)	黑暗守墓者 / 暗黑恶梦 (解密 C)	Eleven / Gavaking
sengok3d	战国传承 3 / 战国传承 2001 (解密 C)	战国传承 3 / 战国传承 2001 (解密 C)	SNK
kof2001d	拳皇 2001 (解密 C)	拳皇 2001 (解密 C)	Eolith / SNK
mslug4d	合金弹头 4 (解密 C)	合金弹头 4 (解密 C)	Mega
rotdd	龙吼 - 双截龙 (解密 C)	龙吼 - 双截龙 (解密 C)	Evoga / Playmore
kof2002d	拳皇 2002 - 终极挑战 (解密 C)	拳皇 2002 - 终极挑战 (解密 C)	Eolith / Playmore
matrimd	斗婚 / 新豪血寺一族 (解密 C)	斗婚 / 新豪血寺一族 (解密 C)	Noise Factory / Atlus
ct2k3ad	卧虎藏龙 2003 (set 2 / 完全解密)	卧虎藏龙 2003 (set 2 / 完全解密)	bootleg
cthd2k3d	卧虎藏龙 2003 (set 1 / 完全解密)	卧虎藏龙 2003 (set 1 / 完全解密)	bootleg
kof10thd	拳皇 10 周年 - 所有队伍的战斗 (盗版 / 完全解密)	拳皇 10 周年 - 所有队伍的战斗 (盗版 / 完全解密)	bootleg
kof2003d	拳皇 2003 (解密 C)	拳皇 2003 (解密 C)	SNK Playmore
mslug5d	合金弹头 5 (解密 C)	合金弹头 5 (解密 C)	SNK / Playmore
samsho5d	侍魂 V / 侍魂 Zero (解密 C)	侍魂 V / 侍魂 Zero (解密 C)	Yuki Enterprise / SNK Playmore
samsh5sd	侍魂 V 特别版 / 侍魂 Zero 特别版 (解密 C)	侍魂 V 特别版 / 侍魂 Zero 特别版 (解密 C)	Yuki Enterprise / SNK Playmore
lans2k4d	雇佣兵 (盗版 / 完全解密)	雇佣兵 (盗版 / 完全解密)	bootleg
svcd	Svc混沌: Snk 对 Capcom (MVS / 解密 C)	Svc混沌: Snk 对 Capcom (MVS / 解密 C)	bootleg
jckeygpd	赌马大赛 (解密 C)	赌马大赛 (解密 C)	Sun Amusement / BrezzaSoft
kf2k3pcd	拳皇 2003 (日版, JAMMA PCB / 解密 C)	拳皇 2003 (日版, JAMMA PCB / 解密 C)	SNK Playmore
kogd	格斗之王 (盗版 / 完全解密)	格斗之王 (盗版 / 完全解密)	bootleg
pnyaad	宠物方块 (解密 C)	宠物方块 (解密 C)	Aiky / Taito
bangbedp	碰碰球 (工程版)	碰碰球 (工程版)	Visco
tjsb	天降神兵	天降神兵	IGS
lhzb2	龙虎争霸 2 (set 1)	龙虎争霸 2 (set 1)	IGS
lhzb2a	龙虎争霸 2 (set 2)	龙虎争霸 2 (set 2)	IGS
lhzb3	龙虎争霸 3	龙虎争霸 3	IGS
lhzb4	龙虎争霸 4	龙虎争霸 4	IGS
mgcs	满贯财神	满贯财神	IGS
slqz2	双龙抢珠 2	双龙抢珠 2	IGS
sdmg2	超级大满贯 2	超级大满贯 2	IGS
sdwx	圣诞无限	圣诞无限	IGS
sddz	超级斗地主	超级斗地主	IGS
klxyj	快乐西游记	快乐西游记	IGS
mgfx	满贯福星	满贯福星	IGS
ddz	斗地主	斗地主	IGS
lhba	龙虎榜 (set 2)	龙虎榜 (set 2)	IGS
dbc	大阪城	大阪城	IGS
mjdchuka	麻雀 大中华圈 (中国, v. D111)	麻雀 大中华圈 (中国, v. D111)	Dynax
mjmyster	麻雀 世界之神秘	麻雀 世界之神秘	Dynax
daireika	麻雀 大灵界	麻雀 大灵界	Jaleco / NMK
omotesnd	表参道 (日版 890215)	表参道 (日版 890215)	ANIME TEC
musobana	梦想花 (日版)	梦想花 (日版)	Nichibutsu/Yubis
mmaiko	舞妓花 [BET] (日版 900911)	舞妓花 [BET] (日版 900911)	Nichibutsu
hnoridur	华折鹤 (日版)	华折鹤 (日版)	Dynax
hkagerou	花札 华阳炎 [BET] (日版)	花札 华阳炎 [BET] (日版)	Nakanihon + Dynax
7jigen	7元次 之 妖精达 (日版)	7元次 之 妖精达 (日版)	Dynax
akiss	麻雀 天使之吻	麻雀 天使之吻	Jaleco
hanamomb	麻雀刺客外传 花之百子组! (日版 881125)	麻雀刺客外传 花之百子组! (日版 881125)	Nichibutsu
iemotom	家元 [BET] (日版 871118)	家元 [BET] (日版 871118)	Nichibutsu
ryuuha	流派 [BET] (日版 871027)	流派 [BET] (日版 871027)	Central Denshi
xmen	X-战警 (4 玩家 ver UBB)	X-战警 (4 玩家 ver UBB)	Konami
xmenj	X-战警 (4 玩家 ver JBA)	X-战警 (4 玩家 ver JBA)	Konami
xmen2p	X-战警 (2 玩家 ver AAA)	X-战警 (2 玩家 ver AAA)	Konami
xmen2pj	X-战警 (2 玩家 ver JAA)	X-战警 (2 玩家 ver JAA)	Konami
xmen6p	X-战警 (6 玩家 ver ECB)	X-战警 (6 玩家 ver ECB)	Konami
xmen6pu	X-战警 (6 玩家 ver UCB)	X-战警 (6 玩家 ver UCB)	Konami